rundate,reporting_period,foreign_region,foreign_country,UK_airport,foreign_airport,this_month_total_pax,this_month_schedueld_pax,this_month_charter_pax,last_month_total_pax,last_month_scheduled_pax,last_month_charter_pax,percent_change,Month,Year
25/07/2013 11:13,201301,WESTERN EUROPE-EU,AUSTRIA,GLASGOW,SALZBURG,1819,0,1819,1671,0,1671,8.856971873,January,2013
25/07/2013 11:13,201301,CARIBBEAN AREA,BARBADOS,GLASGOW,BRIDGETOWN,991,0,991,1281,0,1281,-22.63856362,January,2013
25/07/2013 11:13,201301,CANADA,CANADA,GLASGOW,TORONTO,2682,2682,0,2284,2284,0,17.42556918,January,2013
25/07/2013 11:13,201301,ATLANTIC OCEAN ISLANDS,CAPE VERDE ISLANDS,GLASGOW,BOA VISTA (RABIL),232,232,0,2051,2051,0,-88.68844466,January,2013
25/07/2013 11:13,201301,CENTRAL AMERICA,CUBA,GLASGOW,CUNAGUA (CAYO COCO),0,0,0,178,0,178,0,January,2013
25/07/2013 11:13,201301,WESTERN EUROPE-EU,CYPRUS,GLASGOW,PAPHOS,273,0,273,1423,0,1423,-80.8151792,January,2013
25/07/2013 11:13,201301,WESTERN EUROPE-EU,DENMARK,GLASGOW,COPENHAGEN,449,449,0,648,648,0,-30.70987654,January,2013
25/07/2013 11:13,201301,NORTH AFRICA,EGYPT,GLASGOW,SHARM EL SHEIKH (OPHIRA),4140,0,4140,6832,0,6832,-39.4028103,January,2013
25/07/2013 11:13,201301,WESTERN EUROPE-EU,FRANCE,GLASGOW,CHAMBERY,1839,0,1839,1569,0,1569,17.208413,January,2013
25/07/2013 11:13,201301,WESTERN EUROPE-EU,FRANCE,GLASGOW,PARIS (CHARLES DE GAULLE),8621,8621,0,8762,8762,0,-1.609221639,January,2013
25/07/2013 11:13,201301,WESTERN EUROPE-EU,GERMANY,GLASGOW,BERLIN (SCHONEFELD),5275,5275,0,5317,5317,0,-0.789919127,January,2013
25/07/2013 11:13,201301,WESTERN EUROPE-EU,GERMANY,GLASGOW,FRANKFURT MAIN,0,0,0,384,384,0,0,January,2013
25/07/2013 11:13,201301,WESTERN EUROPE-OTHER,ICELAND,GLASGOW,KEFLAVIK,2341,2341,0,2019,2019,0,15.94848935,January,2013
25/07/2013 11:13,201301,WESTERN EUROPE-EU,IRISH REPUBLIC,GLASGOW,CORK,1485,1485,0,1346,1346,0,10.3268945,January,2013
25/07/2013 11:13,201301,WESTERN EUROPE-EU,IRISH REPUBLIC,GLASGOW,DONEGAL,478,478,0,397,397,0,20.40302267,January,2013
25/07/2013 11:13,201301,WESTERN EUROPE-EU,IRISH REPUBLIC,GLASGOW,DUBLIN,9461,9461,0,9350,9176,174,1.187165775,January,2013
25/07/2013 11:13,201301,WESTERN EUROPE-EU,ITALY,GLASGOW,TURIN,1826,0,1826,1997,0,1997,-8.562844266,January,2013
25/07/2013 11:13,201301,CENTRAL AMERICA,MEXICO,GLASGOW,CANCUN,0,0,0,386,0,386,0,January,2013
25/07/2013 11:13,201301,WESTERN EUROPE-EU,NETHERLANDS,GLASGOW,AMSTERDAM,23597,23597,0,26256,26256,0,-10.12720902,January,2013
25/07/2013 11:13,201301,WESTERN EUROPE-OTHER,NORWAY,GLASGOW,STAVANGER,148,148,0,298,298,0,-50.33557047,January,2013
25/07/2013 11:13,201301,WESTERN EUROPE-EU,PORTUGAL(EXCLUDING MADEIRA),GLASGOW,FARO,2960,2960,0,2647,2647,0,11.82470722,January,2013
25/07/2013 11:13,201301,WESTERN EUROPE-EU,PORTUGAL(MADEIRA),GLASGOW,FUNCHAL,1644,0,1644,2128,0,2128,-22.7443609,January,2013
25/07/2013 11:13,201301,WESTERN EUROPE-EU,SPAIN,GLASGOW,ALICANTE,7236,4981,2255,8555,5940,2615,-15.41788428,January,2013
25/07/2013 11:13,201301,WESTERN EUROPE-EU,SPAIN,GLASGOW,MADRID,0,0,0,528,528,0,0,January,2013
25/07/2013 11:13,201301,WESTERN EUROPE-EU,SPAIN,GLASGOW,MALAGA,5780,5780,0,5627,5627,0,2.719033233,January,2013
25/07/2013 11:13,201301,WESTERN EUROPE-EU,SPAIN,GLASGOW,PALMA DE MALLORCA,2094,2094,0,0,0,0,0,January,2013
25/07/2013 11:13,201301,WESTERN EUROPE-EU,SPAIN(CANARY ISLANDS),GLASGOW,ARRECIFE,8978,2065,6913,8361,0,8361,7.37950006,January,2013
25/07/2013 11:13,201301,WESTERN EUROPE-EU,SPAIN(CANARY ISLANDS),GLASGOW,FUERTEVENTURA,6943,0,6943,3997,0,3997,73.70527896,January,2013
25/07/2013 11:13,201301,WESTERN EUROPE-EU,SPAIN(CANARY ISLANDS),GLASGOW,LAS PALMAS,3950,0,3950,5428,0,5428,-27.22918202,January,2013
25/07/2013 11:13,201301,WESTERN EUROPE-EU,SPAIN(CANARY ISLANDS),GLASGOW,TENERIFE (SURREINA SOFIA),18912,4013,14899,21913,3914,17999,-13.69506686,January,2013
25/07/2013 11:13,201301,WESTERN EUROPE-OTHER,SWITZERLAND,GLASGOW,GENEVA,2746,2746,0,6088,4646,1442,-54.89487516,January,2013
25/07/2013 11:13,201301,NORTH AFRICA,TUNISIA,GLASGOW,ENFIDHA,281,0,281,510,0,510,-44.90196078,January,2013
25/07/2013 11:13,201301,WESTERN EUROPE-OTHER,TURKEY,GLASGOW,ANTALYA,367,0,367,1993,0,1993,-81.58554942,January,2013
25/07/2013 11:13,201301,MIDDLE EAST,UNITED ARAB EMIRATES,GLASGOW,DUBAI,32820,32572,248,24167,24167,0,35.80502338,January,2013
25/07/2013 11:13,201301,UNITED STATES OF AMERICA,USA,GLASGOW,NEW YORK (NEWARK),6415,6415,0,5817,5817,0,10.28021317,January,2013
25/07/2013 11:24,201302,WESTERN EUROPE-EU,AUSTRIA,GLASGOW,SALZBURG,1643,0,1643,1668,0,1668,-1.498800959,February,2013
25/07/2013 11:24,201302,CARIBBEAN AREA,BARBADOS,GLASGOW,BRIDGETOWN,986,0,986,1839,0,1839,-46.3839043,February,2013
25/07/2013 11:24,201302,CANADA,CANADA,GLASGOW,TORONTO,1884,1884,0,1800,1800,0,4.666666667,February,2013
25/07/2013 11:24,201302,ATLANTIC OCEAN ISLANDS,CAPE VERDE ISLANDS,GLASGOW,BOA VISTA (RABIL),0,0,0,1509,1509,0,0,February,2013
25/07/2013 11:24,201302,WESTERN EUROPE-EU,CYPRUS,GLASGOW,PAPHOS,0,0,0,1963,0,1963,0,February,2013
25/07/2013 11:24,201302,WESTERN EUROPE-EU,DENMARK,GLASGOW,COPENHAGEN,586,586,0,1026,1026,0,-42.88499025,February,2013
25/07/2013 11:24,201302,NORTH AFRICA,EGYPT,GLASGOW,SHARM EL SHEIKH (OPHIRA),3427,0,3427,4915,0,4915,-30.27466938,February,2013
25/07/2013 11:24,201302,WESTERN EUROPE-EU,FRANCE,GLASGOW,CHAMBERY,1192,0,1192,1626,0,1626,-26.69126691,February,2013
25/07/2013 11:24,201302,WESTERN EUROPE-EU,FRANCE,GLASGOW,PARIS (CHARLES DE GAULLE),9399,9399,0,9450,9450,0,-0.53968254,February,2013
25/07/2013 11:24,201302,WESTERN EUROPE-EU,GERMANY,GLASGOW,BERLIN (SCHONEFELD),5464,5464,0,4938,4938,0,10.65208586,February,2013
25/07/2013 11:24,201302,WESTERN EUROPE-EU,GERMANY,GLASGOW,FRANKFURT MAIN,0,0,0,452,452,0,0,February,2013
25/07/2013 11:24,201302,WESTERN EUROPE-OTHER,ICELAND,GLASGOW,KEFLAVIK,2970,2970,0,2448,2448,0,21.32352941,February,2013
25/07/2013 11:24,201302,WESTERN EUROPE-EU,IRISH REPUBLIC,GLASGOW,CORK,1738,1738,0,1567,1567,0,10.91257179,February,2013
25/07/2013 11:24,201302,WESTERN EUROPE-EU,IRISH REPUBLIC,GLASGOW,DONEGAL,568,568,0,355,355,0,60,February,2013
25/07/2013 11:24,201302,WESTERN EUROPE-EU,IRISH REPUBLIC,GLASGOW,DUBLIN,10158,10158,0,9268,9181,87,9.60293483,February,2013
25/07/2013 11:24,201302,WESTERN EUROPE-EU,ITALY,GLASGOW,MILAN (MALPENSA),528,0,528,0,0,0,0,February,2013
25/07/2013 11:24,201302,WESTERN EUROPE-EU,ITALY,GLASGOW,TRIESTE (RONCHI DEI LEGIONARI),0,0,0,239,0,239,0,February,2013
25/07/2013 11:24,201302,WESTERN EUROPE-EU,ITALY,GLASGOW,TURIN,1459,0,1459,1722,0,1722,-15.27293844,February,2013
25/07/2013 11:24,201302,WESTERN EUROPE-EU,NETHERLANDS,GLASGOW,AMSTERDAM,24427,24427,0,25667,25667,0,-4.83110609,February,2013
25/07/2013 11:24,201302,WESTERN EUROPE-OTHER,NORWAY,GLASGOW,STAVANGER,162,162,0,315,297,18,-48.57142857,February,2013
25/07/2013 11:24,201302,WESTERN EUROPE-EU,PORTUGAL(EXCLUDING MADEIRA),GLASGOW,FARO,2539,2539,0,2969,2969,0,-14.48299091,February,2013
25/07/2013 11:24,201302,WESTERN EUROPE-EU,PORTUGAL(MADEIRA),GLASGOW,FUNCHAL,1642,0,1642,1647,0,1647,-0.303582271,February,2013
25/07/2013 11:24,201302,WESTERN EUROPE-EU,SPAIN,GLASGOW,ALICANTE,6781,4837,1944,7997,5406,2591,-15.20570214,February,2013
25/07/2013 11:24,201302,WESTERN EUROPE-EU,SPAIN,GLASGOW,BARCELONA,0,0,0,60,0,60,0,February,2013
25/07/2013 11:24,201302,WESTERN EUROPE-EU,SPAIN,GLASGOW,MADRID,0,0,0,572,572,0,0,February,2013
25/07/2013 11:24,201302,WESTERN EUROPE-EU,SPAIN,GLASGOW,MALAGA,6455,6455,0,6181,6181,0,4.432939654,February,2013
25/07/2013 11:24,201302,WESTERN EUROPE-EU,SPAIN,GLASGOW,PALMA DE MALLORCA,2190,2190,0,0,0,0,0,February,2013
25/07/2013 11:24,201302,WESTERN EUROPE-EU,SPAIN(CANARY ISLANDS),GLASGOW,ARRECIFE,7949,2953,4996,5294,0,5294,50.15111447,February,2013
25/07/2013 11:24,201302,WESTERN EUROPE-EU,SPAIN(CANARY ISLANDS),GLASGOW,FUERTEVENTURA,4939,0,4939,5598,0,5598,-11.77206145,February,2013
25/07/2013 11:24,201302,WESTERN EUROPE-EU,SPAIN(CANARY ISLANDS),GLASGOW,LAS PALMAS,3392,0,3392,2966,0,2966,14.36277815,February,2013
25/07/2013 11:24,201302,WESTERN EUROPE-EU,SPAIN(CANARY ISLANDS),GLASGOW,SANTA CRUZ DE LA PALMA,184,0,184,0,0,0,0,February,2013
25/07/2013 11:24,201302,WESTERN EUROPE-EU,SPAIN(CANARY ISLANDS),GLASGOW,TENERIFE (SURREINA SOFIA),14595,4703,9892,16178,3305,12873,-9.784893065,February,2013
25/07/2013 11:24,201302,WESTERN EUROPE-EU,SWEDEN,GLASGOW,GOTEBORG,114,0,114,0,0,0,0,February,2013
25/07/2013 11:24,201302,WESTERN EUROPE-OTHER,SWITZERLAND,GLASGOW,GENEVA,3278,3278,0,6438,5113,1325,-49.08356632,February,2013
25/07/2013 11:24,201302,NORTH AFRICA,TUNISIA,GLASGOW,ENFIDHA,683,0,683,520,0,520,31.34615385,February,2013
25/07/2013 11:24,201302,WESTERN EUROPE-OTHER,TURKEY,GLASGOW,ANTALYA,289,0,289,2585,0,2585,-88.82011605,February,2013
25/07/2013 11:24,201302,MIDDLE EAST,UNITED ARAB EMIRATES,GLASGOW,DUBAI,27217,27217,0,21928,21928,0,24.11984677,February,2013
25/07/2013 11:24,201302,UNITED STATES OF AMERICA,USA,GLASGOW,LAS VEGAS,102,0,102,0,0,0,0,February,2013
25/07/2013 11:24,201302,UNITED STATES OF AMERICA,USA,GLASGOW,NEW YORK (NEWARK),5818,5818,0,5438,5438,0,6.987863185,February,2013
26/06/2013 10:21,201303,WESTERN EUROPE-EU,AUSTRIA,GLASGOW,SALZBURG,658,0,658,654,0,654,0.611620795,March,2013
26/06/2013 10:21,201303,CARIBBEAN AREA,BARBADOS,GLASGOW,BRIDGETOWN,702,0,702,1273,0,1273,-44.854674,March,2013
26/06/2013 10:21,201303,CANADA,CANADA,GLASGOW,TORONTO,1963,1963,0,2429,2429,0,-19.18484973,March,2013
26/06/2013 10:21,201303,ATLANTIC OCEAN ISLANDS,CAPE VERDE ISLANDS,GLASGOW,BOA VISTA (RABIL),0,0,0,1410,1410,0,0,March,2013
26/06/2013 10:21,201303,WESTERN EUROPE-EU,CYPRUS,GLASGOW,LARNACA,0,0,0,236,0,236,0,March,2013
26/06/2013 10:21,201303,WESTERN EUROPE-EU,CYPRUS,GLASGOW,PAPHOS,1372,0,1372,1800,0,1800,-23.77777778,March,2013
26/06/2013 10:21,201303,WESTERN EUROPE-EU,DENMARK,GLASGOW,COPENHAGEN,649,649,0,1269,1269,0,-48.85736801,March,2013
26/06/2013 10:21,201303,NORTH AFRICA,EGYPT,GLASGOW,SHARM EL SHEIKH (OPHIRA),3473,0,3473,5848,0,5848,-40.6121751,March,2013
26/06/2013 10:21,201303,WESTERN EUROPE-EU,FRANCE,GLASGOW,CHAMBERY,2153,0,2153,2061,0,2061,4.463852499,March,2013
26/06/2013 10:21,201303,WESTERN EUROPE-EU,FRANCE,GLASGOW,PARIS (CHARLES DE GAULLE),11384,11094,290,9801,9801,0,16.15141312,March,2013
26/06/2013 10:21,201303,WESTERN EUROPE-EU,GERMANY,GLASGOW,BERLIN (SCHONEFELD),6095,6095,0,6300,6300,0,-3.253968254,March,2013
26/06/2013 10:21,201303,WESTERN EUROPE-EU,GERMANY,GLASGOW,DUSSELDORF,11,0,11,0,0,0,0,March,2013
26/06/2013 10:21,201303,WESTERN EUROPE-EU,GERMANY,GLASGOW,FRANKFURT MAIN,0,0,0,355,355,0,0,March,2013
26/06/2013 10:21,201303,WESTERN EUROPE-OTHER,ICELAND,GLASGOW,KEFLAVIK,3725,3725,0,2778,2778,0,34.08927286,March,2013
26/06/2013 10:21,201303,WESTERN EUROPE-EU,IRISH REPUBLIC,GLASGOW,CORK,2079,2079,0,2028,2028,0,2.514792899,March,2013
26/06/2013 10:21,201303,WESTERN EUROPE-EU,IRISH REPUBLIC,GLASGOW,DONEGAL,733,733,0,514,514,0,42.60700389,March,2013
26/06/2013 10:21,201303,WESTERN EUROPE-EU,IRISH REPUBLIC,GLASGOW,DUBLIN,12157,12085,72,11996,11996,0,1.342114038,March,2013
26/06/2013 10:21,201303,WESTERN EUROPE-EU,ITALY,GLASGOW,NAPLES,0,0,0,167,0,167,0,March,2013
26/06/2013 10:21,201303,WESTERN EUROPE-EU,ITALY,GLASGOW,ROME (FIUMICINO),593,593,0,1600,1157,443,-62.9375,March,2013
26/06/2013 10:21,201303,WESTERN EUROPE-EU,ITALY,GLASGOW,TRIESTE (RONCHI DEI LEGIONARI),0,0,0,240,0,240,0,March,2013
26/06/2013 10:21,201303,WESTERN EUROPE-EU,ITALY,GLASGOW,TURIN,3986,0,3986,1737,0,1737,129.4761082,March,2013
26/06/2013 10:21,201303,WESTERN EUROPE-EU,MALTA,GLASGOW,MALTA,79,0,79,0,0,0,0,March,2013
26/06/2013 10:21,201303,CENTRAL AMERICA,MEXICO,GLASGOW,CANCUN,0,0,0,326,0,326,0,March,2013
26/06/2013 10:21,201303,WESTERN EUROPE-EU,NETHERLANDS,GLASGOW,AMSTERDAM,28710,28710,0,32161,32161,0,-10.73038774,March,2013
26/06/2013 10:21,201303,WESTERN EUROPE-OTHER,NORWAY,GLASGOW,STAVANGER,136,136,0,333,333,0,-59.15915916,March,2013
26/06/2013 10:21,201303,EASTERN EUROPE-EU,POLAND,GLASGOW,GDANSK,1812,1812,0,0,0,0,0,March,2013
26/06/2013 10:21,201303,EASTERN EUROPE-EU,POLAND,GLASGOW,WARSAW,2324,2324,0,0,0,0,0,March,2013
26/06/2013 10:21,201303,WESTERN EUROPE-EU,PORTUGAL(EXCLUDING MADEIRA),GLASGOW,FARO,3383,3383,0,4466,4244,222,-24.24988804,March,2013
26/06/2013 10:21,201303,WESTERN EUROPE-EU,PORTUGAL(MADEIRA),GLASGOW,FUNCHAL,1547,0,1547,1729,0,1729,-10.52631579,March,2013
26/06/2013 10:21,201303,WESTERN EUROPE-OTHER,REPUBLIC OF SERBIA,GLASGOW,BELGRADE,202,0,202,0,0,0,0,March,2013
26/06/2013 10:21,201303,WESTERN EUROPE-EU,SPAIN,GLASGOW,ALICANTE,10205,6042,4163,12577,7728,4849,-18.85982349,March,2013
26/06/2013 10:21,201303,WESTERN EUROPE-EU,SPAIN,GLASGOW,BARCELONA,588,588,0,455,455,0,29.23076923,March,2013
26/06/2013 10:21,201303,WESTERN EUROPE-EU,SPAIN,GLASGOW,MADRID,0,0,0,573,573,0,0,March,2013
26/06/2013 10:21,201303,WESTERN EUROPE-EU,SPAIN,GLASGOW,MALAGA,8760,8191,569,10543,8537,2006,-16.91169496,March,2013
26/06/2013 10:21,201303,WESTERN EUROPE-EU,SPAIN,GLASGOW,PALMA DE MALLORCA,3841,3243,598,1267,934,333,203.1570639,March,2013
26/06/2013 10:21,201303,WESTERN EUROPE-EU,SPAIN(CANARY ISLANDS),GLASGOW,ARRECIFE,10007,4006,6001,7070,227,6843,41.5417256,March,2013
26/06/2013 10:21,201303,WESTERN EUROPE-EU,SPAIN(CANARY ISLANDS),GLASGOW,FUERTEVENTURA,5805,0,5805,5897,0,5897,-1.560115313,March,2013
26/06/2013 10:21,201303,WESTERN EUROPE-EU,SPAIN(CANARY ISLANDS),GLASGOW,LAS PALMAS,3871,0,3871,3934,0,3934,-1.601423488,March,2013
26/06/2013 10:21,201303,WESTERN EUROPE-EU,SPAIN(CANARY ISLANDS),GLASGOW,TENERIFE (SURREINA SOFIA),20908,6236,14672,21016,4111,16905,-0.513894176,March,2013
26/06/2013 10:21,201303,WESTERN EUROPE-OTHER,SWITZERLAND,GLASGOW,GENEVA,3355,3355,0,6227,4507,1720,-46.12172796,March,2013
26/06/2013 10:21,201303,NORTH AFRICA,TUNISIA,GLASGOW,ENFIDHA,2381,0,2381,1486,0,1486,60.22880215,March,2013
26/06/2013 10:21,201303,WESTERN EUROPE-OTHER,TURKEY,GLASGOW,ANTALYA,4114,0,4114,3989,0,3989,3.133617448,March,2013
26/06/2013 10:21,201303,WESTERN EUROPE-OTHER,TURKEY,GLASGOW,DALAMAN,256,0,256,515,0,515,-50.29126214,March,2013
26/06/2013 10:21,201303,MIDDLE EAST,UNITED ARAB EMIRATES,GLASGOW,DUBAI,33001,33001,0,23787,23787,0,38.73544373,March,2013
26/06/2013 10:21,201303,UNITED STATES OF AMERICA,USA,GLASGOW,LAS VEGAS,320,0,320,321,0,321,-0.31152648,March,2013
26/06/2013 10:21,201303,UNITED STATES OF AMERICA,USA,GLASGOW,NEW YORK (NEWARK),8024,8024,0,7847,7847,0,2.255639098,March,2013
26/06/2013 10:21,201303,UNITED STATES OF AMERICA,USA,GLASGOW,ORLANDO,1286,1286,0,59,59,0,2079.661017,March,2013
26/06/2013 10:22,201304,CARIBBEAN AREA,BARBADOS,GLASGOW,BRIDGETOWN,246,0,246,474,0,474,-48.10126582,April,2013
26/06/2013 10:22,201304,CANADA,CANADA,GLASGOW,TORONTO,1973,1973,0,3918,3918,0,-49.64267483,April,2013
26/06/2013 10:22,201304,CANADA,CANADA,GLASGOW,VANCOUVER,0,0,0,590,590,0,0,April,2013
26/06/2013 10:22,201304,ATLANTIC OCEAN ISLANDS,CAPE VERDE ISLANDS,GLASGOW,BOA VISTA (RABIL),0,0,0,1808,1808,0,0,April,2013
26/06/2013 10:22,201304,WESTERN EUROPE-EU,CYPRUS,GLASGOW,LARNACA,1611,0,1611,1681,0,1681,-4.164187983,April,2013
26/06/2013 10:22,201304,WESTERN EUROPE-EU,CYPRUS,GLASGOW,PAPHOS,4713,1258,3455,5984,2386,3598,-21.23997326,April,2013
26/06/2013 10:22,201304,WESTERN EUROPE-EU,DENMARK,GLASGOW,COPENHAGEN,787,787,0,1251,1251,0,-37.09032774,April,2013
26/06/2013 10:22,201304,NORTH AFRICA,EGYPT,GLASGOW,SHARM EL SHEIKH (OPHIRA),3585,0,3585,5955,0,5955,-39.79848866,April,2013
26/06/2013 10:22,201304,WESTERN EUROPE-EU,FRANCE,GLASGOW,CHAMBERY,209,0,209,231,0,231,-9.523809524,April,2013
26/06/2013 10:22,201304,WESTERN EUROPE-EU,FRANCE,GLASGOW,PARIS (CHARLES DE GAULLE),11526,11526,0,10458,10458,0,10.21227768,April,2013
26/06/2013 10:22,201304,WESTERN EUROPE-EU,GERMANY,GLASGOW,BERLIN (SCHONEFELD),5452,5452,0,6897,6897,0,-20.95113818,April,2013
26/06/2013 10:22,201304,WESTERN EUROPE-EU,GERMANY,GLASGOW,DUSSELDORF,1731,1731,0,0,0,0,0,April,2013
26/06/2013 10:22,201304,WESTERN EUROPE-EU,GREECE,GLASGOW,HERAKLION,0,0,0,232,0,232,0,April,2013
26/06/2013 10:22,201304,WESTERN EUROPE-OTHER,ICELAND,GLASGOW,KEFLAVIK,3784,3784,0,2863,2863,0,32.16905344,April,2013
26/06/2013 10:22,201304,WESTERN EUROPE-EU,IRISH REPUBLIC,GLASGOW,CORK,1837,1837,0,2199,2199,0,-16.46202819,April,2013
26/06/2013 10:22,201304,WESTERN EUROPE-EU,IRISH REPUBLIC,GLASGOW,DONEGAL,676,676,0,681,681,0,-0.734214391,April,2013
26/06/2013 10:22,201304,WESTERN EUROPE-EU,IRISH REPUBLIC,GLASGOW,DUBLIN,12038,11551,487,11625,11625,0,3.552688172,April,2013
26/06/2013 10:22,201304,WESTERN EUROPE-EU,ITALY,GLASGOW,NAPLES,0,0,0,1093,0,1093,0,April,2013
26/06/2013 10:22,201304,WESTERN EUROPE-EU,ITALY,GLASGOW,ROME (FIUMICINO),2523,2523,0,3360,3360,0,-24.91071429,April,2013
26/06/2013 10:22,201304,WESTERN EUROPE-EU,ITALY,GLASGOW,TURIN,207,0,207,677,0,677,-69.4239291,April,2013
26/06/2013 10:22,201304,WESTERN EUROPE-EU,MALTA,GLASGOW,MALTA,0,0,0,1793,0,1793,0,April,2013
26/06/2013 10:22,201304,CENTRAL AMERICA,MEXICO,GLASGOW,CANCUN,0,0,0,2081,0,2081,0,April,2013
26/06/2013 10:22,201304,WESTERN EUROPE-EU,NETHERLANDS,GLASGOW,AMSTERDAM,34227,34098,129,32267,32267,0,6.074317414,April,2013
26/06/2013 10:22,201304,WESTERN EUROPE-OTHER,NORWAY,GLASGOW,STAVANGER,158,158,0,349,349,0,-54.7277937,April,2013
26/06/2013 10:22,201304,EASTERN EUROPE-EU,POLAND,GLASGOW,GDANSK,2550,2550,0,0,0,0,0,April,2013
26/06/2013 10:22,201304,EASTERN EUROPE-EU,POLAND,GLASGOW,WARSAW,1950,1950,0,0,0,0,0,April,2013
26/06/2013 10:22,201304,WESTERN EUROPE-EU,PORTUGAL(EXCLUDING MADEIRA),GLASGOW,FARO,6386,6386,0,8211,6859,1352,-22.22628182,April,2013
26/06/2013 10:22,201304,WESTERN EUROPE-EU,PORTUGAL(MADEIRA),GLASGOW,FUNCHAL,1980,0,1980,2023,0,2023,-2.125556105,April,2013
26/06/2013 10:22,201304,WESTERN EUROPE-EU,SPAIN,GLASGOW,ALICANTE,19571,13867,5704,18763,13187,5576,4.306347599,April,2013
26/06/2013 10:22,201304,WESTERN EUROPE-EU,SPAIN,GLASGOW,BARCELONA,2491,2491,0,3669,3669,0,-32.1068411,April,2013
26/06/2013 10:22,201304,WESTERN EUROPE-EU,SPAIN,GLASGOW,MADRID,0,0,0,864,864,0,0,April,2013
26/06/2013 10:22,201304,WESTERN EUROPE-EU,SPAIN,GLASGOW,MALAGA,15040,13329,1711,14236,12455,1781,5.647653835,April,2013
26/06/2013 10:22,201304,WESTERN EUROPE-EU,SPAIN,GLASGOW,PALMA DE MALLORCA,12462,8708,3754,13310,8479,4831,-6.371149512,April,2013
26/06/2013 10:22,201304,WESTERN EUROPE-EU,SPAIN(CANARY ISLANDS),GLASGOW,ARRECIFE,7686,2248,5438,8619,1194,7425,-10.82492168,April,2013
26/06/2013 10:22,201304,WESTERN EUROPE-EU,SPAIN(CANARY ISLANDS),GLASGOW,FUERTEVENTURA,4937,0,4937,5129,0,5129,-3.74341977,April,2013
26/06/2013 10:22,201304,WESTERN EUROPE-EU,SPAIN(CANARY ISLANDS),GLASGOW,LAS PALMAS,3469,0,3469,3988,0,3988,-13.01404213,April,2013
26/06/2013 10:22,201304,WESTERN EUROPE-EU,SPAIN(CANARY ISLANDS),GLASGOW,TENERIFE (SURREINA SOFIA),18861,5537,13324,20798,5214,15584,-9.313395519,April,2013
26/06/2013 10:22,201304,WESTERN EUROPE-OTHER,SWITZERLAND,GLASGOW,GENEVA,956,956,0,2432,2200,232,-60.69078947,April,2013
26/06/2013 10:22,201304,NORTH AFRICA,TUNISIA,GLASGOW,ENFIDHA,4931,0,4931,3575,0,3575,37.93006993,April,2013
26/06/2013 10:22,201304,WESTERN EUROPE-OTHER,TURKEY,GLASGOW,ANTALYA,7268,0,7268,8034,0,8034,-9.534478467,April,2013
26/06/2013 10:22,201304,WESTERN EUROPE-OTHER,TURKEY,GLASGOW,DALAMAN,3633,0,3633,5094,0,5094,-28.68080094,April,2013
26/06/2013 10:22,201304,MIDDLE EAST,UNITED ARAB EMIRATES,GLASGOW,DUBAI,31952,31952,0,21339,21339,0,49.73522658,April,2013
26/06/2013 10:22,201304,UNITED STATES OF AMERICA,USA,GLASGOW,LAS VEGAS,317,0,317,320,0,320,-0.9375,April,2013
26/06/2013 10:22,201304,UNITED STATES OF AMERICA,USA,GLASGOW,NEW YORK (NEWARK),9049,9049,0,8917,8917,0,1.480318493,April,2013
26/06/2013 10:22,201304,UNITED STATES OF AMERICA,USA,GLASGOW,ORLANDO,4280,4280,0,2656,2656,0,61.14457831,April,2013
26/06/2013 10:22,201304,UNITED STATES OF AMERICA,USA,GLASGOW,SANFORD,1946,0,1946,2608,0,2608,-25.38343558,April,2013
09/08/2013 09:04,201305,WESTERN EUROPE-EU,AUSTRIA,GLASGOW,SALZBURG,89,0,89,105,0,105,-15.23809524,May,2013
09/08/2013 09:04,201305,WESTERN EUROPE-EU,BELGIUM,GLASGOW,ANTWERP,43,0,43,0,0,0,0,May,2013
09/08/2013 09:04,201305,WESTERN EUROPE-EU,BELGIUM,GLASGOW,BRUSSELS,48,0,48,0,0,0,0,May,2013
09/08/2013 09:04,201305,EASTERN EUROPE-EU,BULGARIA,GLASGOW,BURGAS,1612,0,1612,1689,0,1689,-4.558910598,May,2013
09/08/2013 09:04,201305,CANADA,CANADA,GLASGOW,CALGARY,174,0,174,2363,2363,0,-92.63647905,May,2013
09/08/2013 09:04,201305,CANADA,CANADA,GLASGOW,TORONTO,8683,8683,0,10767,10767,0,-19.35543791,May,2013
09/08/2013 09:04,201305,CANADA,CANADA,GLASGOW,VANCOUVER,2618,2618,0,3400,3400,0,-23,May,2013
09/08/2013 09:04,201305,ATLANTIC OCEAN ISLANDS,CAPE VERDE ISLANDS,GLASGOW,BOA VISTA (RABIL),0,0,0,1707,1707,0,0,May,2013
09/08/2013 09:04,201305,WESTERN EUROPE-EU,CYPRUS,GLASGOW,LARNACA,5104,0,5104,5380,0,5380,-5.130111524,May,2013
09/08/2013 09:04,201305,WESTERN EUROPE-EU,CYPRUS,GLASGOW,PAPHOS,4785,3314,1471,5316,3224,2092,-9.988713318,May,2013
09/08/2013 09:04,201305,WESTERN EUROPE-EU,DENMARK,GLASGOW,COPENHAGEN,995,995,0,1581,1581,0,-37.06514864,May,2013
09/08/2013 09:04,201305,NORTH AFRICA,EGYPT,GLASGOW,SHARM EL SHEIKH (OPHIRA),4850,0,4850,5258,0,5258,-7.759604412,May,2013
09/08/2013 09:04,201305,WESTERN EUROPE-EU,FRANCE,GLASGOW,LYON,0,0,0,660,0,660,0,May,2013
09/08/2013 09:04,201305,WESTERN EUROPE-EU,FRANCE,GLASGOW,NANTES,116,0,116,165,0,165,-29.6969697,May,2013
09/08/2013 09:04,201305,WESTERN EUROPE-EU,FRANCE,GLASGOW,NICE,0,0,0,825,821,4,0,May,2013
09/08/2013 09:04,201305,WESTERN EUROPE-EU,FRANCE,GLASGOW,PARIS (CHARLES DE GAULLE),12459,12343,116,10772,10557,215,15.66097289,May,2013
09/08/2013 09:04,201305,WESTERN EUROPE-EU,FRANCE,GLASGOW,PAU,0,0,0,166,0,166,0,May,2013
09/08/2013 09:04,201305,WESTERN EUROPE-EU,FRANCE,GLASGOW,TARBES-LOURDES INTERNATIONAL,193,0,193,0,0,0,0,May,2013
09/08/2013 09:04,201305,WESTERN EUROPE-EU,GERMANY,GLASGOW,BERLIN (SCHONEFELD),6224,6224,0,7339,7339,0,-15.19280556,May,2013
09/08/2013 09:04,201305,WESTERN EUROPE-EU,GERMANY,GLASGOW,COLOGNE BONN,0,0,0,115,0,115,0,May,2013
09/08/2013 09:04,201305,WESTERN EUROPE-EU,GERMANY,GLASGOW,DUSSELDORF,2964,2964,0,0,0,0,0,May,2013
09/08/2013 09:04,201305,WESTERN EUROPE-EU,GREECE,GLASGOW,CORFU,3297,0,3297,3498,0,3498,-5.746140652,May,2013
09/08/2013 09:04,201305,WESTERN EUROPE-EU,GREECE,GLASGOW,HERAKLION,3861,884,2977,6136,451,5685,-37.07627119,May,2013
09/08/2013 09:04,201305,WESTERN EUROPE-EU,GREECE,GLASGOW,KOS,225,0,225,776,0,776,-71.00515464,May,2013
09/08/2013 09:04,201305,WESTERN EUROPE-EU,GREECE,GLASGOW,RHODES,3994,514,3480,3974,485,3489,0.503271263,May,2013
09/08/2013 09:04,201305,WESTERN EUROPE-EU,GREECE,GLASGOW,ZAKINTHOS,1521,0,1521,2140,0,2140,-28.92523364,May,2013
09/08/2013 09:04,201305,EASTERN EUROPE-EU,HUNGARY,GLASGOW,BUDAPEST,34,0,34,0,0,0,0,May,2013
09/08/2013 09:04,201305,WESTERN EUROPE-OTHER,ICELAND,GLASGOW,KEFLAVIK,4457,4457,0,2896,2896,0,53.9019337,May,2013
09/08/2013 09:04,201305,WESTERN EUROPE-EU,IRISH REPUBLIC,GLASGOW,CORK,2199,2199,0,1744,1744,0,26.08944954,May,2013
09/08/2013 09:04,201305,WESTERN EUROPE-EU,IRISH REPUBLIC,GLASGOW,DONEGAL,677,677,0,624,624,0,8.493589744,May,2013
09/08/2013 09:04,201305,WESTERN EUROPE-EU,IRISH REPUBLIC,GLASGOW,DUBLIN,12767,12679,88,11551,11448,103,10.52722708,May,2013
09/08/2013 09:04,201305,WESTERN EUROPE-EU,IRISH REPUBLIC,GLASGOW,SHANNON,739,739,0,0,0,0,0,May,2013
09/08/2013 09:04,201305,WESTERN EUROPE-EU,ITALY,GLASGOW,BERGAMO,0,0,0,341,0,341,0,May,2013
09/08/2013 09:04,201305,WESTERN EUROPE-EU,ITALY,GLASGOW,NAPLES,1654,0,1654,1630,0,1630,1.472392638,May,2013
09/08/2013 09:04,201305,WESTERN EUROPE-EU,ITALY,GLASGOW,ROME (FIUMICINO),3076,3076,0,3663,3663,0,-16.02511603,May,2013
09/08/2013 09:04,201305,WESTERN EUROPE-EU,ITALY,GLASGOW,VENICE,103,0,103,810,0,810,-87.28395062,May,2013
09/08/2013 09:04,201305,WESTERN EUROPE-EU,ITALY,GLASGOW,VERONA VILLAFRANCA,1972,0,1972,1487,0,1487,32.61600538,May,2013
09/08/2013 09:04,201305,WESTERN EUROPE-EU,MALTA,GLASGOW,MALTA,865,0,865,1972,0,1972,-56.13590264,May,2013
09/08/2013 09:04,201305,CENTRAL AMERICA,MEXICO,GLASGOW,CANCUN,3287,0,3287,4300,0,4300,-23.55813953,May,2013
09/08/2013 09:04,201305,NORTH AFRICA,MOROCCO,GLASGOW,MARRAKESH,79,0,79,0,0,0,0,May,2013
09/08/2013 09:04,201305,WESTERN EUROPE-EU,NETHERLANDS,GLASGOW,AMSTERDAM,36778,36778,0,32827,32827,0,12.03582417,May,2013
09/08/2013 09:04,201305,WESTERN EUROPE-OTHER,NORWAY,GLASGOW,STAVANGER,127,127,0,319,319,0,-60.18808777,May,2013
09/08/2013 09:04,201305,EASTERN EUROPE-EU,POLAND,GLASGOW,GDANSK,2687,2687,0,0,0,0,0,May,2013
09/08/2013 09:04,201305,EASTERN EUROPE-EU,POLAND,GLASGOW,WARSAW,2324,2324,0,0,0,0,0,May,2013
09/08/2013 09:04,201305,WESTERN EUROPE-EU,PORTUGAL(EXCLUDING MADEIRA),GLASGOW,FARO,10118,8165,1953,12038,8131,3907,-15.94949327,May,2013
09/08/2013 09:04,201305,WESTERN EUROPE-EU,PORTUGAL(MADEIRA),GLASGOW,FUNCHAL,1577,0,1577,1701,0,1701,-7.289829512,May,2013
09/08/2013 09:04,201305,WESTERN EUROPE-EU,SPAIN,GLASGOW,ALICANTE,22566,16335,6231,21781,14936,6845,3.604058583,May,2013
09/08/2013 09:04,201305,WESTERN EUROPE-EU,SPAIN,GLASGOW,BARCELONA,3112,3014,98,4424,4281,143,-29.65641953,May,2013
09/08/2013 09:04,201305,WESTERN EUROPE-EU,SPAIN,GLASGOW,IBIZA,7389,2012,5377,7656,1129,6527,-3.487460815,May,2013
09/08/2013 09:04,201305,WESTERN EUROPE-EU,SPAIN,GLASGOW,MADRID,0,0,0,903,903,0,0,May,2013
09/08/2013 09:04,201305,WESTERN EUROPE-EU,SPAIN,GLASGOW,MAHON,3300,156,3144,3863,0,3863,-14.57416516,May,2013
09/08/2013 09:04,201305,WESTERN EUROPE-EU,SPAIN,GLASGOW,MALAGA,17202,14858,2344,16650,14036,2614,3.315315315,May,2013
09/08/2013 09:04,201305,WESTERN EUROPE-EU,SPAIN,GLASGOW,MURCIA SAN JAVIER,737,737,0,0,0,0,0,May,2013
09/08/2013 09:04,201305,WESTERN EUROPE-EU,SPAIN,GLASGOW,PALMA DE MALLORCA,26340,11974,14366,29442,11121,18321,-10.53596902,May,2013
09/08/2013 09:04,201305,WESTERN EUROPE-EU,SPAIN,GLASGOW,REUS,4576,0,4576,6707,0,6707,-31.77277471,May,2013
09/08/2013 09:04,201305,WESTERN EUROPE-EU,SPAIN(CANARY ISLANDS),GLASGOW,ARRECIFE,10003,2563,7440,6363,1595,4768,57.20572057,May,2013
09/08/2013 09:04,201305,WESTERN EUROPE-EU,SPAIN(CANARY ISLANDS),GLASGOW,FUERTEVENTURA,1832,0,1832,1901,0,1901,-3.629668595,May,2013
09/08/2013 09:04,201305,WESTERN EUROPE-EU,SPAIN(CANARY ISLANDS),GLASGOW,LAS PALMAS,4173,216,3957,3786,0,3786,10.22187005,May,2013
09/08/2013 09:04,201305,WESTERN EUROPE-EU,SPAIN(CANARY ISLANDS),GLASGOW,TENERIFE (SURREINA SOFIA),14889,5723,9166,16023,5354,10669,-7.077326343,May,2013
09/08/2013 09:04,201305,NORTH AFRICA,TUNISIA,GLASGOW,ENFIDHA,6072,0,6072,4009,0,4009,51.45921676,May,2013
09/08/2013 09:04,201305,WESTERN EUROPE-OTHER,TURKEY,GLASGOW,ANTALYA,6582,0,6582,6553,0,6553,0.442545399,May,2013
09/08/2013 09:04,201305,WESTERN EUROPE-OTHER,TURKEY,GLASGOW,BODRUM (MILAS),3695,672,3023,3134,0,3134,17.90044671,May,2013
09/08/2013 09:04,201305,WESTERN EUROPE-OTHER,TURKEY,GLASGOW,DALAMAN,11711,2433,9278,14746,1877,12869,-20.58185271,May,2013
09/08/2013 09:04,201305,MIDDLE EAST,UNITED ARAB EMIRATES,GLASGOW,DUBAI,26370,26370,0,19995,19995,0,31.88297074,May,2013
09/08/2013 09:04,201305,UNITED STATES OF AMERICA,USA,GLASGOW,NEW YORK (NEWARK),9777,9777,0,9200,9200,0,6.27173913,May,2013
09/08/2013 09:04,201305,UNITED STATES OF AMERICA,USA,GLASGOW,ORLANDO,3185,3185,0,3591,3591,0,-11.30604288,May,2013
09/08/2013 09:04,201305,UNITED STATES OF AMERICA,USA,GLASGOW,PHILADELPHIA INTERNATIONAL,1741,1741,0,1233,1233,0,41.20032441,May,2013
09/08/2013 09:04,201305,UNITED STATES OF AMERICA,USA,GLASGOW,SANFORD,6002,4456,1546,5973,0,5973,0.485518165,May,2013
14/08/2013 10:19,201306,WESTERN EUROPE-EU,AUSTRIA,GLASGOW,SALZBURG,1079,0,1079,1066,0,1066,1.219512195,June,2013
14/08/2013 10:19,201306,EASTERN EUROPE-EU,BULGARIA,GLASGOW,BURGAS,6909,0,6909,6595,0,6595,4.761182714,June,2013
14/08/2013 10:19,201306,CANADA,CANADA,GLASGOW,CALGARY,785,785,0,2024,2024,0,-61.21541502,June,2013
14/08/2013 10:19,201306,CANADA,CANADA,GLASGOW,TORONTO,9102,9102,0,12732,12732,0,-28.51083883,June,2013
14/08/2013 10:19,201306,CANADA,CANADA,GLASGOW,VANCOUVER,2523,2523,0,2431,2431,0,3.784450843,June,2013
14/08/2013 10:19,201306,ATLANTIC OCEAN ISLANDS,CAPE VERDE ISLANDS,GLASGOW,BOA VISTA (RABIL),0,0,0,1810,1810,0,0,June,2013
14/08/2013 10:19,201306,WESTERN EUROPE-EU,CROATIA,GLASGOW,PULA,441,441,0,0,0,0,0,June,2013
14/08/2013 10:19,201306,WESTERN EUROPE-EU,CROATIA,GLASGOW,ZAGREB,210,0,210,0,0,0,0,June,2013
14/08/2013 10:19,201306,CENTRAL AMERICA,CUBA,GLASGOW,CUNAGUA (CAYO COCO),323,0,323,323,0,323,0,June,2013
14/08/2013 10:19,201306,WESTERN EUROPE-EU,CYPRUS,GLASGOW,LARNACA,6073,0,6073,6879,0,6879,-11.71681931,June,2013
14/08/2013 10:19,201306,WESTERN EUROPE-EU,CYPRUS,GLASGOW,PAPHOS,6281,3692,2589,7203,3501,3702,-12.80022213,June,2013
14/08/2013 10:19,201306,WESTERN EUROPE-EU,DENMARK,GLASGOW,COPENHAGEN,1178,1178,0,1555,1555,0,-24.24437299,June,2013
14/08/2013 10:19,201306,CENTRAL AMERICA,DOMINICAN REPUBLIC,GLASGOW,PUERTO PLATA,0,0,0,326,0,326,0,June,2013
14/08/2013 10:19,201306,NORTH AFRICA,EGYPT,GLASGOW,SHARM EL SHEIKH (OPHIRA),6019,0,6019,5665,0,5665,6.248896734,June,2013
14/08/2013 10:19,201306,WESTERN EUROPE-EU,FRANCE,GLASGOW,CLERMONT FERRAND,428,0,428,201,0,201,112.9353234,June,2013
14/08/2013 10:19,201306,WESTERN EUROPE-EU,FRANCE,GLASGOW,LYON,618,0,618,1653,0,1653,-62.61343013,June,2013
14/08/2013 10:19,201306,WESTERN EUROPE-EU,FRANCE,GLASGOW,MARSEILLE,103,0,103,0,0,0,0,June,2013
14/08/2013 10:19,201306,WESTERN EUROPE-EU,FRANCE,GLASGOW,NANTES,964,0,964,943,0,943,2.226935313,June,2013
14/08/2013 10:19,201306,WESTERN EUROPE-EU,FRANCE,GLASGOW,NICE,0,0,0,2446,2446,0,0,June,2013
14/08/2013 10:19,201306,WESTERN EUROPE-EU,FRANCE,GLASGOW,PARIS (CHARLES DE GAULLE),12703,11802,901,11268,10977,291,12.73517927,June,2013
14/08/2013 10:19,201306,WESTERN EUROPE-EU,GERMANY,GLASGOW,BERLIN (SCHONEFELD),5794,5794,0,7994,7994,0,-27.52064048,June,2013
14/08/2013 10:19,201306,WESTERN EUROPE-EU,GERMANY,GLASGOW,DUSSELDORF,3305,3305,0,0,0,0,0,June,2013
14/08/2013 10:19,201306,WESTERN EUROPE-EU,GREECE,GLASGOW,CORFU,3873,0,3873,6403,0,6403,-39.51272841,June,2013
14/08/2013 10:19,201306,WESTERN EUROPE-EU,GREECE,GLASGOW,HERAKLION,8356,2907,5449,7197,1386,5811,16.10393219,June,2013
14/08/2013 10:19,201306,WESTERN EUROPE-EU,GREECE,GLASGOW,KOS,1493,0,1493,1917,0,1917,-22.11789254,June,2013
14/08/2013 10:19,201306,WESTERN EUROPE-EU,GREECE,GLASGOW,RHODES,5340,1383,3957,5227,1344,3883,2.161851923,June,2013
14/08/2013 10:19,201306,WESTERN EUROPE-EU,GREECE,GLASGOW,ZAKINTHOS,4546,0,4546,4809,0,4809,-5.468912456,June,2013
14/08/2013 10:19,201306,WESTERN EUROPE-OTHER,ICELAND,GLASGOW,KEFLAVIK,4596,4596,0,3476,3476,0,32.22094361,June,2013
14/08/2013 10:19,201306,WESTERN EUROPE-OTHER,ICELAND,GLASGOW,REYKJAVIK,24,0,24,0,0,0,0,June,2013
14/08/2013 10:19,201306,WESTERN EUROPE-EU,IRISH REPUBLIC,GLASGOW,CORK,1881,1881,0,1873,1873,0,0.427122264,June,2013
14/08/2013 10:19,201306,WESTERN EUROPE-EU,IRISH REPUBLIC,GLASGOW,DONEGAL,758,758,0,741,741,0,2.294197031,June,2013
14/08/2013 10:19,201306,WESTERN EUROPE-EU,IRISH REPUBLIC,GLASGOW,DUBLIN,12451,12451,0,12396,12396,0,0.443691513,June,2013
14/08/2013 10:19,201306,WESTERN EUROPE-EU,IRISH REPUBLIC,GLASGOW,SHANNON,749,749,0,0,0,0,0,June,2013
14/08/2013 10:19,201306,WESTERN EUROPE-EU,ITALY,GLASGOW,NAPLES,1481,0,1481,2224,0,2224,-33.40827338,June,2013
14/08/2013 10:19,201306,WESTERN EUROPE-EU,ITALY,GLASGOW,ROME (FIUMICINO),3744,3449,295,3930,3930,0,-4.732824427,June,2013
14/08/2013 10:19,201306,WESTERN EUROPE-EU,ITALY,GLASGOW,VENICE,959,0,959,1653,0,1653,-41.98427102,June,2013
14/08/2013 10:19,201306,WESTERN EUROPE-EU,ITALY,GLASGOW,VERONA VILLAFRANCA,3681,0,3681,3575,0,3575,2.965034965,June,2013
14/08/2013 10:19,201306,WESTERN EUROPE-EU,MALTA,GLASGOW,MALTA,1042,0,1042,1701,0,1701,-38.74191652,June,2013
14/08/2013 10:19,201306,CENTRAL AMERICA,MEXICO,GLASGOW,CANCUN,4838,0,4838,4606,0,4606,5.03690838,June,2013
14/08/2013 10:19,201306,WESTERN EUROPE-EU,NETHERLANDS,GLASGOW,AMSTERDAM,37420,37420,0,32264,32264,0,15.98065956,June,2013
14/08/2013 10:19,201306,WESTERN EUROPE-OTHER,NORWAY,GLASGOW,OSLO (GARDERMOEN),285,0,285,0,0,0,0,June,2013
14/08/2013 10:19,201306,WESTERN EUROPE-OTHER,NORWAY,GLASGOW,STAVANGER,120,120,0,382,382,0,-68.58638743,June,2013
14/08/2013 10:19,201306,EASTERN EUROPE-EU,POLAND,GLASGOW,GDANSK,2548,2548,0,0,0,0,0,June,2013
14/08/2013 10:19,201306,EASTERN EUROPE-EU,POLAND,GLASGOW,WARSAW,2551,2551,0,0,0,0,0,June,2013
14/08/2013 10:19,201306,WESTERN EUROPE-EU,PORTUGAL(EXCLUDING MADEIRA),GLASGOW,FARO,12386,9768,2618,13783,9241,4542,-10.13567438,June,2013
14/08/2013 10:19,201306,WESTERN EUROPE-EU,PORTUGAL(MADEIRA),GLASGOW,FUNCHAL,1717,0,1717,1757,0,1757,-2.276607854,June,2013
14/08/2013 10:19,201306,WESTERN EUROPE-EU,SPAIN,GLASGOW,ALICANTE,25845,18051,7794,22366,15903,6463,15.55486006,June,2013
14/08/2013 10:19,201306,WESTERN EUROPE-EU,SPAIN,GLASGOW,BARCELONA,5202,4255,947,5463,4688,775,-4.777594728,June,2013
14/08/2013 10:19,201306,WESTERN EUROPE-EU,SPAIN,GLASGOW,IBIZA,15978,6523,9455,12598,3756,8842,26.8296555,June,2013
14/08/2013 10:19,201306,WESTERN EUROPE-EU,SPAIN,GLASGOW,MADRID,0,0,0,806,806,0,0,June,2013
14/08/2013 10:19,201306,WESTERN EUROPE-EU,SPAIN,GLASGOW,MAHON,6114,1437,4677,7386,0,7386,-17.22177092,June,2013
14/08/2013 10:19,201306,WESTERN EUROPE-EU,SPAIN,GLASGOW,MALAGA,18178,15424,2754,19533,15708,3825,-6.936978447,June,2013
14/08/2013 10:19,201306,WESTERN EUROPE-EU,SPAIN,GLASGOW,MURCIA SAN JAVIER,2339,2339,0,0,0,0,0,June,2013
14/08/2013 10:19,201306,WESTERN EUROPE-EU,SPAIN,GLASGOW,PALMA DE MALLORCA,42441,17104,25337,35854,13928,21926,18.37172979,June,2013
14/08/2013 10:19,201306,WESTERN EUROPE-EU,SPAIN,GLASGOW,REUS,6884,0,6884,6919,0,6919,-0.505853447,June,2013
14/08/2013 10:19,201306,WESTERN EUROPE-EU,SPAIN(CANARY ISLANDS),GLASGOW,ARRECIFE,9766,3226,6540,8425,1831,6594,15.91691395,June,2013
14/08/2013 10:19,201306,WESTERN EUROPE-EU,SPAIN(CANARY ISLANDS),GLASGOW,FUERTEVENTURA,2402,0,2402,1539,0,1539,56.07537362,June,2013
14/08/2013 10:19,201306,WESTERN EUROPE-EU,SPAIN(CANARY ISLANDS),GLASGOW,LAS PALMAS,5384,1799,3585,3615,0,3615,48.93499308,June,2013
14/08/2013 10:19,201306,WESTERN EUROPE-EU,SPAIN(CANARY ISLANDS),GLASGOW,TENERIFE (SURREINA SOFIA),18322,7511,10811,18679,5980,12699,-1.911237218,June,2013
14/08/2013 10:19,201306,NORTH AFRICA,TUNISIA,GLASGOW,ENFIDHA - HAMMAMET INTL,6781,0,6781,3620,0,3620,87.32044199,June,2013
14/08/2013 10:19,201306,WESTERN EUROPE-OTHER,TURKEY,GLASGOW,ANTALYA,8436,0,8436,9423,0,9423,-10.47437122,June,2013
14/08/2013 10:19,201306,WESTERN EUROPE-OTHER,TURKEY,GLASGOW,BODRUM (MILAS),6216,2748,3468,5009,0,5009,24.09662607,June,2013
14/08/2013 10:19,201306,WESTERN EUROPE-OTHER,TURKEY,GLASGOW,DALAMAN,20208,5111,15097,21476,3811,17665,-5.904265226,June,2013
14/08/2013 10:19,201306,MIDDLE EAST,UNITED ARAB EMIRATES,GLASGOW,DUBAI,31190,31190,0,27187,27187,0,14.72394895,June,2013
14/08/2013 10:19,201306,UNITED STATES OF AMERICA,USA,GLASGOW,NEW YORK (NEWARK),9514,9514,0,8666,8666,0,9.785368105,June,2013
14/08/2013 10:19,201306,UNITED STATES OF AMERICA,USA,GLASGOW,ORLANDO,6284,6284,0,5496,5496,0,14.33770015,June,2013
14/08/2013 10:19,201306,UNITED STATES OF AMERICA,USA,GLASGOW,PHILADELPHIA INTERNATIONAL,9014,9014,0,8767,8767,0,2.817383369,June,2013
14/08/2013 10:19,201306,UNITED STATES OF AMERICA,USA,GLASGOW,SANFORD,8347,5757,2590,8912,0,8912,-6.339766607,June,2013
20/11/2013 14:01,201307,WESTERN EUROPE-EU,AUSTRIA,GLASGOW,GRAZ,356,0,356,0,0,0,0,July,2013
20/11/2013 14:01,201307,WESTERN EUROPE-EU,AUSTRIA,GLASGOW,SALZBURG,931,0,931,900,0,900,3.444444444,July,2013
20/11/2013 14:01,201307,WESTERN EUROPE-EU,AUSTRIA,GLASGOW,VIENNA,477,0,477,0,0,0,0,July,2013
20/11/2013 14:01,201307,EASTERN EUROPE-EU,BULGARIA,GLASGOW,BURGAS,7967,0,7967,8476,0,8476,-6.005191128,July,2013
20/11/2013 14:01,201307,CANADA,CANADA,GLASGOW,CALGARY,2000,2000,0,2358,2358,0,-15.18235793,July,2013
20/11/2013 14:01,201307,CANADA,CANADA,GLASGOW,TORONTO,10376,10376,0,15723,15723,0,-34.00750493,July,2013
20/11/2013 14:01,201307,CANADA,CANADA,GLASGOW,VANCOUVER,3081,3081,0,2574,2574,0,19.6969697,July,2013
20/11/2013 14:01,201307,ATLANTIC OCEAN ISLANDS,CAPE VERDE ISLANDS,GLASGOW,BOA VISTA (RABIL),0,0,0,2277,2277,0,0,July,2013
20/11/2013 14:01,201307,WESTERN EUROPE-EU,CROATIA,GLASGOW,DUBROVNIK,321,0,321,317,0,317,1.261829653,July,2013
20/11/2013 14:01,201307,WESTERN EUROPE-EU,CROATIA,GLASGOW,PULA,1345,1345,0,0,0,0,0,July,2013
20/11/2013 14:01,201307,CENTRAL AMERICA,CUBA,GLASGOW,CUNAGUA (CAYO COCO),324,0,324,336,0,336,-3.571428571,July,2013
20/11/2013 14:01,201307,WESTERN EUROPE-EU,CYPRUS,GLASGOW,LARNACA,6126,0,6126,8680,0,8680,-29.42396313,July,2013
20/11/2013 14:01,201307,WESTERN EUROPE-EU,CYPRUS,GLASGOW,PAPHOS,5526,3776,1750,9490,3987,5503,-41.77028451,July,2013
20/11/2013 14:01,201307,WESTERN EUROPE-EU,DENMARK,GLASGOW,COPENHAGEN,1573,1573,0,1807,1807,0,-12.94964029,July,2013
20/11/2013 14:01,201307,CENTRAL AMERICA,DOMINICAN REPUBLIC,GLASGOW,PUERTO PLATA,0,0,0,324,0,324,0,July,2013
20/11/2013 14:01,201307,NORTH AFRICA,EGYPT,GLASGOW,SHARM EL SHEIKH (OPHIRA),5431,0,5431,6182,0,6182,-12.14817211,July,2013
20/11/2013 14:01,201307,WESTERN EUROPE-OTHER,FAROE ISLANDS,GLASGOW,VAGAR,166,0,166,0,0,0,0,July,2013
20/11/2013 14:01,201307,WESTERN EUROPE-EU,FINLAND,GLASGOW,HELSINKI,0,0,0,685,0,685,0,July,2013
20/11/2013 14:01,201307,WESTERN EUROPE-EU,FRANCE,GLASGOW,LYON,500,0,500,577,0,577,-13.34488735,July,2013
20/11/2013 14:01,201307,WESTERN EUROPE-EU,FRANCE,GLASGOW,NANTES,0,0,0,579,0,579,0,July,2013
20/11/2013 14:01,201307,WESTERN EUROPE-EU,FRANCE,GLASGOW,NICE,0,0,0,3037,3037,0,0,July,2013
20/11/2013 14:01,201307,WESTERN EUROPE-EU,FRANCE,GLASGOW,PARIS (CHARLES DE GAULLE),13979,13426,553,11711,11711,0,19.36640765,July,2013
20/11/2013 14:01,201307,WESTERN EUROPE-EU,FRANCE,GLASGOW,PARIS (LE BOURGET),0,0,0,40,0,40,0,July,2013
20/11/2013 14:01,201307,WESTERN EUROPE-EU,FRANCE,GLASGOW,TARBES-LOURDES INTERNATIONAL,448,0,448,438,0,438,2.283105023,July,2013
20/11/2013 14:01,201307,WESTERN EUROPE-EU,GERMANY,GLASGOW,BERLIN (SCHONEFELD),6373,6373,0,9075,9075,0,-29.77410468,July,2013
20/11/2013 14:01,201307,WESTERN EUROPE-EU,GERMANY,GLASGOW,DUSSELDORF,4628,4548,80,0,0,0,0,July,2013
20/11/2013 14:01,201307,WESTERN EUROPE-EU,GERMANY,GLASGOW,FRANKFURT MAIN,0,0,0,180,0,180,0,July,2013
20/11/2013 14:01,201307,WESTERN EUROPE-EU,GREECE,GLASGOW,ATHENS,0,0,0,67,0,67,0,July,2013
20/11/2013 14:01,201307,WESTERN EUROPE-EU,GREECE,GLASGOW,CORFU,4183,0,4183,5553,0,5553,-24.67134882,July,2013
20/11/2013 14:01,201307,WESTERN EUROPE-EU,GREECE,GLASGOW,HERAKLION,10681,3121,7560,7960,1628,6332,34.18341709,July,2013
20/11/2013 14:01,201307,WESTERN EUROPE-EU,GREECE,GLASGOW,KOS,1576,0,1576,1797,0,1797,-12.2982749,July,2013
20/11/2013 14:01,201307,WESTERN EUROPE-EU,GREECE,GLASGOW,RHODES,4835,1578,3257,5278,1466,3812,-8.393330807,July,2013
20/11/2013 14:01,201307,WESTERN EUROPE-EU,GREECE,GLASGOW,ZAKINTHOS,4217,0,4217,6669,0,6669,-36.7671315,July,2013
20/11/2013 14:01,201307,WESTERN EUROPE-OTHER,ICELAND,GLASGOW,KEFLAVIK,4788,4788,0,3785,3785,0,26.4993395,July,2013
20/11/2013 14:01,201307,WESTERN EUROPE-EU,IRISH REPUBLIC,GLASGOW,CORK,2235,2235,0,2186,2186,0,2.241537054,July,2013
20/11/2013 14:01,201307,WESTERN EUROPE-EU,IRISH REPUBLIC,GLASGOW,DONEGAL,1269,1269,0,1098,1098,0,15.57377049,July,2013
20/11/2013 14:01,201307,WESTERN EUROPE-EU,IRISH REPUBLIC,GLASGOW,DUBLIN,12425,12425,0,12901,12901,0,-3.689636462,July,2013
20/11/2013 14:01,201307,WESTERN EUROPE-EU,IRISH REPUBLIC,GLASGOW,SHANNON,1041,1041,0,90,0,90,1056.666667,July,2013
20/11/2013 14:01,201307,WESTERN EUROPE-EU,ITALY,GLASGOW,MILAN (MALPENSA),0,0,0,99,0,99,0,July,2013
20/11/2013 14:01,201307,WESTERN EUROPE-EU,ITALY,GLASGOW,NAPLES,1481,0,1481,1818,0,1818,-18.53685369,July,2013
20/11/2013 14:01,201307,WESTERN EUROPE-EU,ITALY,GLASGOW,ROME (FIUMICINO),3643,3643,0,5037,5037,0,-27.67520349,July,2013
20/11/2013 14:01,201307,WESTERN EUROPE-EU,ITALY,GLASGOW,VENICE,581,0,581,1605,0,1605,-63.80062305,July,2013
20/11/2013 14:01,201307,WESTERN EUROPE-EU,ITALY,GLASGOW,VERONA VILLAFRANCA,3884,0,3884,3546,0,3546,9.531866892,July,2013
20/11/2013 14:01,201307,WESTERN EUROPE-EU,MALTA,GLASGOW,MALTA,1327,0,1327,2233,0,2233,-40.57321988,July,2013
20/11/2013 14:01,201307,CENTRAL AMERICA,MEXICO,GLASGOW,CANCUN,7794,0,7794,6528,0,6528,19.39338235,July,2013
20/11/2013 14:01,201307,WESTERN EUROPE-EU,NETHERLANDS,GLASGOW,AMSTERDAM,37956,37956,0,32725,32725,0,15.98472116,July,2013
20/11/2013 14:01,201307,WESTERN EUROPE-EU,NETHERLANDS,GLASGOW,GRONINGEN,38,0,38,0,0,0,0,July,2013
20/11/2013 14:01,201307,WESTERN EUROPE-OTHER,NORWAY,GLASGOW,STAVANGER,100,100,0,348,348,0,-71.26436782,July,2013
20/11/2013 14:01,201307,OIL RIGS,OIL RIGS,GLASGOW,OIL RIGS,11,0,11,0,0,0,0,July,2013
20/11/2013 14:01,201307,EASTERN EUROPE-EU,POLAND,GLASGOW,GDANSK,3032,3032,0,0,0,0,0,July,2013
20/11/2013 14:01,201307,EASTERN EUROPE-EU,POLAND,GLASGOW,WARSAW,2864,2864,0,101,0,101,2735.643564,July,2013
20/11/2013 14:01,201307,WESTERN EUROPE-EU,PORTUGAL(EXCLUDING MADEIRA),GLASGOW,FARO,13022,10555,2467,14390,10989,3401,-9.506601807,July,2013
20/11/2013 14:01,201307,WESTERN EUROPE-EU,PORTUGAL(MADEIRA),GLASGOW,FUNCHAL,2211,0,2211,2270,0,2270,-2.599118943,July,2013
20/11/2013 14:01,201307,WESTERN EUROPE-EU,SPAIN,GLASGOW,ALICANTE,27225,19781,7444,23239,16157,7082,17.15220104,July,2013
20/11/2013 14:01,201307,WESTERN EUROPE-EU,SPAIN,GLASGOW,BARCELONA,5208,4450,758,5724,4767,957,-9.014675052,July,2013
20/11/2013 14:01,201307,WESTERN EUROPE-EU,SPAIN,GLASGOW,IBIZA,16931,7841,9090,14602,6153,8449,15.94986988,July,2013
20/11/2013 14:01,201307,WESTERN EUROPE-EU,SPAIN,GLASGOW,MADRID,691,0,691,877,877,0,-21.20866591,July,2013
20/11/2013 14:01,201307,WESTERN EUROPE-EU,SPAIN,GLASGOW,MAHON,5113,1134,3979,6642,0,6642,-23.02017465,July,2013
20/11/2013 14:01,201307,WESTERN EUROPE-EU,SPAIN,GLASGOW,MALAGA,19132,16604,2528,19413,15850,3563,-1.447483645,July,2013
20/11/2013 14:01,201307,WESTERN EUROPE-EU,SPAIN,GLASGOW,MURCIA SAN JAVIER,2581,2581,0,0,0,0,0,July,2013
20/11/2013 14:01,201307,WESTERN EUROPE-EU,SPAIN,GLASGOW,PALMA DE MALLORCA,44269,17669,26600,41415,14212,27203,6.891222987,July,2013
20/11/2013 14:01,201307,WESTERN EUROPE-EU,SPAIN,GLASGOW,REUS,7000,0,7000,7659,0,7659,-8.60425643,July,2013
20/11/2013 14:01,201307,WESTERN EUROPE-EU,SPAIN,GLASGOW,VALENCIA,571,0,571,0,0,0,0,July,2013
20/11/2013 14:01,201307,WESTERN EUROPE-EU,SPAIN(CANARY ISLANDS),GLASGOW,ARRECIFE,13294,3666,9628,11573,1794,9779,14.87082001,July,2013
20/11/2013 14:01,201307,WESTERN EUROPE-EU,SPAIN(CANARY ISLANDS),GLASGOW,FUERTEVENTURA,1986,0,1986,2107,0,2107,-5.742762221,July,2013
20/11/2013 14:01,201307,WESTERN EUROPE-EU,SPAIN(CANARY ISLANDS),GLASGOW,LAS PALMAS,5510,1466,4044,5053,0,5053,9.044132199,July,2013
20/11/2013 14:01,201307,WESTERN EUROPE-EU,SPAIN(CANARY ISLANDS),GLASGOW,TENERIFE (SURREINA SOFIA),17754,7560,10194,18245,6038,12207,-2.69114826,July,2013
20/11/2013 14:01,201307,WESTERN EUROPE-EU,SWEDEN,GLASGOW,GOTEBORG,308,0,308,0,0,0,0,July,2013
20/11/2013 14:01,201307,NORTH AFRICA,TUNISIA,GLASGOW,ENFIDHA - HAMMAMET INTL,7172,0,7172,3955,0,3955,81.34007585,July,2013
20/11/2013 14:01,201307,WESTERN EUROPE-OTHER,TURKEY,GLASGOW,ANTALYA,9750,0,9750,11267,0,11267,-13.4640987,July,2013
20/11/2013 14:01,201307,WESTERN EUROPE-OTHER,TURKEY,GLASGOW,BODRUM (MILAS),7627,3216,4411,6672,0,6672,14.31354916,July,2013
20/11/2013 14:01,201307,WESTERN EUROPE-OTHER,TURKEY,GLASGOW,DALAMAN,33793,6839,26954,26118,5119,20999,29.38586415,July,2013
20/11/2013 14:01,201307,EASTERN EUROPE -OTHER,UKRAINE,GLASGOW,DONETSK,40,0,40,0,0,0,0,July,2013
20/11/2013 14:01,201307,MIDDLE EAST,UNITED ARAB EMIRATES,GLASGOW,DUBAI,34429,34429,0,30185,30185,0,14.05996356,July,2013
20/11/2013 14:01,201307,UNITED STATES OF AMERICA,USA,GLASGOW,LAS VEGAS,0,0,0,353,0,353,0,July,2013
20/11/2013 14:01,201307,UNITED STATES OF AMERICA,USA,GLASGOW,NEW YORK (NEWARK),9829,9829,0,9355,9355,0,5.066809193,July,2013
20/11/2013 14:01,201307,UNITED STATES OF AMERICA,USA,GLASGOW,ORLANDO,6287,6287,0,6336,6336,0,-0.773358586,July,2013
20/11/2013 14:01,201307,UNITED STATES OF AMERICA,USA,GLASGOW,PHILADELPHIA INTERNATIONAL,9810,9810,0,9535,9535,0,2.884111169,July,2013
20/11/2013 14:01,201307,UNITED STATES OF AMERICA,USA,GLASGOW,SANFORD,11542,5439,6103,13432,0,13432,-14.07087552,July,2013
11/10/2013 11:57,201308,WESTERN EUROPE-EU,AUSTRIA,GLASGOW,GRAZ,409,0,409,420,0,420,-2.619047619,August,2013
11/10/2013 11:57,201308,WESTERN EUROPE-EU,AUSTRIA,GLASGOW,LINZ,408,0,408,0,0,0,0,August,2013
11/10/2013 11:57,201308,WESTERN EUROPE-EU,AUSTRIA,GLASGOW,SALZBURG,1123,0,1123,888,0,888,26.46396396,August,2013
11/10/2013 11:57,201308,WESTERN EUROPE-EU,AUSTRIA,GLASGOW,VIENNA,920,0,920,710,0,710,29.57746479,August,2013
11/10/2013 11:57,201308,EASTERN EUROPE-EU,BULGARIA,GLASGOW,BURGAS,5436,0,5436,5319,0,5319,2.199661591,August,2013
11/10/2013 11:57,201308,CANADA,CANADA,GLASGOW,CALGARY,1350,1350,0,2900,2900,0,-53.44827586,August,2013
11/10/2013 11:57,201308,CANADA,CANADA,GLASGOW,TORONTO,10997,10997,0,16821,16821,0,-34.62338743,August,2013
11/10/2013 11:57,201308,CANADA,CANADA,GLASGOW,VANCOUVER,2470,2470,0,3397,3397,0,-27.28878422,August,2013
11/10/2013 11:57,201308,ATLANTIC OCEAN ISLANDS,CAPE VERDE ISLANDS,GLASGOW,BOA VISTA (RABIL),0,0,0,1858,1858,0,0,August,2013
11/10/2013 11:57,201308,WESTERN EUROPE-EU,CROATIA,GLASGOW,DUBROVNIK,157,0,157,322,0,322,-51.24223602,August,2013
11/10/2013 11:57,201308,WESTERN EUROPE-EU,CROATIA,GLASGOW,PULA,1080,1080,0,0,0,0,0,August,2013
11/10/2013 11:57,201308,WESTERN EUROPE-EU,CYPRUS,GLASGOW,LARNACA,5606,0,5606,8173,0,8173,-31.40829561,August,2013
11/10/2013 11:57,201308,WESTERN EUROPE-EU,CYPRUS,GLASGOW,PAPHOS,5096,3324,1772,6530,4059,2471,-21.96018377,August,2013
11/10/2013 11:57,201308,WESTERN EUROPE-EU,DENMARK,GLASGOW,COPENHAGEN,1526,1526,0,1754,1754,0,-12.99885975,August,2013
11/10/2013 11:57,201308,NORTH AFRICA,EGYPT,GLASGOW,SHARM EL SHEIKH (OPHIRA),5917,0,5917,5930,0,5930,-0.219224283,August,2013
11/10/2013 11:57,201308,WESTERN EUROPE-OTHER,FAROE ISLANDS,GLASGOW,VAGAR,179,0,179,0,0,0,0,August,2013
11/10/2013 11:57,201308,WESTERN EUROPE-EU,FINLAND,GLASGOW,HELSINKI,0,0,0,458,0,458,0,August,2013
11/10/2013 11:57,201308,WESTERN EUROPE-EU,FRANCE,GLASGOW,NICE,0,0,0,2867,2867,0,0,August,2013
11/10/2013 11:57,201308,WESTERN EUROPE-EU,FRANCE,GLASGOW,PARIS (CHARLES DE GAULLE),13197,13197,0,11458,11458,0,15.17716879,August,2013
11/10/2013 11:57,201308,WESTERN EUROPE-EU,GERMANY,GLASGOW,BERLIN (SCHONEFELD),6383,6383,0,9046,9046,0,-29.43842582,August,2013
11/10/2013 11:57,201308,WESTERN EUROPE-EU,GERMANY,GLASGOW,DUSSELDORF,4459,4459,0,67,0,67,6555.223881,August,2013
11/10/2013 11:57,201308,WESTERN EUROPE-EU,GREECE,GLASGOW,ATHENS,0,0,0,363,0,363,0,August,2013
11/10/2013 11:57,201308,WESTERN EUROPE-EU,GREECE,GLASGOW,CORFU,4034,0,4034,4369,0,4369,-7.667658503,August,2013
11/10/2013 11:57,201308,WESTERN EUROPE-EU,GREECE,GLASGOW,HERAKLION,7033,3186,3847,7967,1629,6338,-11.72335886,August,2013
11/10/2013 11:57,201308,WESTERN EUROPE-EU,GREECE,GLASGOW,KOS,2144,0,2144,2271,0,2271,-5.59225011,August,2013
11/10/2013 11:57,201308,WESTERN EUROPE-EU,GREECE,GLASGOW,RHODES,3950,1634,2316,5888,1801,4087,-32.91440217,August,2013
11/10/2013 11:57,201308,WESTERN EUROPE-EU,GREECE,GLASGOW,ZAKINTHOS,4036,0,4036,5914,0,5914,-31.75515725,August,2013
11/10/2013 11:57,201308,WESTERN EUROPE-OTHER,ICELAND,GLASGOW,KEFLAVIK,5341,5341,0,3809,3809,0,40.22053032,August,2013
11/10/2013 11:57,201308,WESTERN EUROPE-EU,IRISH REPUBLIC,GLASGOW,CORK,2244,2244,0,2336,2336,0,-3.938356164,August,2013
11/10/2013 11:57,201308,WESTERN EUROPE-EU,IRISH REPUBLIC,GLASGOW,DONEGAL,1234,1234,0,1139,1139,0,8.340649693,August,2013
11/10/2013 11:57,201308,WESTERN EUROPE-EU,IRISH REPUBLIC,GLASGOW,DUBLIN,13435,13358,77,12337,12337,0,8.90005674,August,2013
11/10/2013 11:57,201308,WESTERN EUROPE-EU,IRISH REPUBLIC,GLASGOW,SHANNON,1307,1307,0,0,0,0,0,August,2013
11/10/2013 11:57,201308,WESTERN EUROPE-EU,ITALY,GLASGOW,NAPLES,1875,0,1875,2247,0,2247,-16.55540721,August,2013
11/10/2013 11:57,201308,WESTERN EUROPE-EU,ITALY,GLASGOW,ROME (FIUMICINO),3681,3681,0,4684,4684,0,-21.41332195,August,2013
11/10/2013 11:57,201308,WESTERN EUROPE-EU,ITALY,GLASGOW,VENICE,725,0,725,1483,0,1483,-51.11260958,August,2013
11/10/2013 11:57,201308,WESTERN EUROPE-EU,ITALY,GLASGOW,VERONA VILLAFRANCA,3730,0,3730,3838,0,3838,-2.813965607,August,2013
11/10/2013 11:57,201308,EASTERN EUROPE -OTHER,KAZAKHSTAN,GLASGOW,ASTANA,50,0,50,0,0,0,0,August,2013
11/10/2013 11:57,201308,WESTERN EUROPE-EU,MALTA,GLASGOW,MALTA,1039,0,1039,1840,0,1840,-43.5326087,August,2013
11/10/2013 11:57,201308,CENTRAL AMERICA,MEXICO,GLASGOW,CANCUN,3164,0,3164,3592,0,3592,-11.91536748,August,2013
11/10/2013 11:57,201308,WESTERN EUROPE-EU,NETHERLANDS,GLASGOW,AMSTERDAM,37880,37880,0,32302,32302,0,17.2682806,August,2013
11/10/2013 11:57,201308,WESTERN EUROPE-OTHER,NORWAY,GLASGOW,STAVANGER,283,39,244,298,298,0,-5.033557047,August,2013
11/10/2013 11:57,201308,EASTERN EUROPE-EU,POLAND,GLASGOW,GDANSK,3056,3056,0,0,0,0,0,August,2013
11/10/2013 11:57,201308,EASTERN EUROPE-EU,POLAND,GLASGOW,KRAKOW,78,0,78,0,0,0,0,August,2013
11/10/2013 11:57,201308,EASTERN EUROPE-EU,POLAND,GLASGOW,WARSAW,2664,2586,78,0,0,0,0,August,2013
11/10/2013 11:57,201308,WESTERN EUROPE-EU,PORTUGAL(EXCLUDING MADEIRA),GLASGOW,FARO,14238,11173,3065,12787,10527,2260,11.34746227,August,2013
11/10/2013 11:57,201308,WESTERN EUROPE-EU,PORTUGAL(MADEIRA),GLASGOW,FUNCHAL,1747,0,1747,1814,0,1814,-3.693495039,August,2013
11/10/2013 11:57,201308,WESTERN EUROPE-EU,SPAIN,GLASGOW,ALICANTE,24721,18781,5940,20825,16402,4423,18.70828331,August,2013
11/10/2013 11:57,201308,WESTERN EUROPE-EU,SPAIN,GLASGOW,BARCELONA,4988,4263,725,5380,4693,687,-7.286245353,August,2013
11/10/2013 11:57,201308,WESTERN EUROPE-EU,SPAIN,GLASGOW,IBIZA,15711,7382,8329,14247,5625,8622,10.27584755,August,2013
11/10/2013 11:57,201308,WESTERN EUROPE-EU,SPAIN,GLASGOW,MADRID,727,0,727,974,974,0,-25.35934292,August,2013
11/10/2013 11:57,201308,WESTERN EUROPE-EU,SPAIN,GLASGOW,MAHON,4778,1429,3349,4461,0,4461,7.106030038,August,2013
11/10/2013 11:57,201308,WESTERN EUROPE-EU,SPAIN,GLASGOW,MALAGA,19395,16249,3146,19899,16075,3824,-2.532790592,August,2013
11/10/2013 11:57,201308,WESTERN EUROPE-EU,SPAIN,GLASGOW,MURCIA SAN JAVIER,2549,2549,0,0,0,0,0,August,2013
11/10/2013 11:57,201308,WESTERN EUROPE-EU,SPAIN,GLASGOW,PALMA DE MALLORCA,34389,17841,16548,29476,14122,15354,16.66779753,August,2013
11/10/2013 11:57,201308,WESTERN EUROPE-EU,SPAIN,GLASGOW,REUS,4238,0,4238,4395,0,4395,-3.572241183,August,2013
11/10/2013 11:57,201308,WESTERN EUROPE-EU,SPAIN,GLASGOW,VALENCIA,709,0,709,487,0,487,45.58521561,August,2013
11/10/2013 11:57,201308,WESTERN EUROPE-EU,SPAIN(CANARY ISLANDS),GLASGOW,ARRECIFE,8406,3747,4659,8628,2263,6365,-2.573018081,August,2013
11/10/2013 11:57,201308,WESTERN EUROPE-EU,SPAIN(CANARY ISLANDS),GLASGOW,FUERTEVENTURA,2067,0,2067,1864,0,1864,10.89055794,August,2013
11/10/2013 11:57,201308,WESTERN EUROPE-EU,SPAIN(CANARY ISLANDS),GLASGOW,LAS PALMAS,4838,1683,3155,3059,0,3059,58.15626022,August,2013
11/10/2013 11:57,201308,WESTERN EUROPE-EU,SPAIN(CANARY ISLANDS),GLASGOW,TENERIFE (SURREINA SOFIA),14408,7593,6815,12881,5659,7222,11.85466967,August,2013
11/10/2013 11:57,201308,WESTERN EUROPE-EU,SWEDEN,GLASGOW,GOTEBORG,162,0,162,0,0,0,0,August,2013
11/10/2013 11:57,201308,WESTERN EUROPE-EU,SWEDEN,GLASGOW,HELSINGBORG-ANGELHOLM,0,0,0,224,0,224,0,August,2013
11/10/2013 11:57,201308,WESTERN EUROPE-EU,SWEDEN,GLASGOW,MALMO,0,0,0,421,0,421,0,August,2013
11/10/2013 11:57,201308,WESTERN EUROPE-OTHER,SWITZERLAND,GLASGOW,ZURICH,175,0,175,0,0,0,0,August,2013
11/10/2013 11:57,201308,NORTH AFRICA,TUNISIA,GLASGOW,ENFIDHA - HAMMAMET INTL,3573,0,3573,2268,0,2268,57.53968254,August,2013
11/10/2013 11:57,201308,WESTERN EUROPE-OTHER,TURKEY,GLASGOW,ANTALYA,2450,0,2450,6007,0,6007,-59.21425004,August,2013
11/10/2013 11:57,201308,WESTERN EUROPE-OTHER,TURKEY,GLASGOW,BODRUM (MILAS),6872,3311,3561,4110,0,4110,67.20194647,August,2013
11/10/2013 11:57,201308,WESTERN EUROPE-OTHER,TURKEY,GLASGOW,DALAMAN,18325,7112,11213,16816,5293,11523,8.973596575,August,2013
11/10/2013 11:57,201308,EASTERN EUROPE -OTHER,UKRAINE,GLASGOW,DONETSK,96,0,96,0,0,0,0,August,2013
11/10/2013 11:57,201308,EASTERN EUROPE -OTHER,UKRAINE,GLASGOW,KIEV (ZHULYANY),96,0,96,0,0,0,0,August,2013
11/10/2013 11:57,201308,MIDDLE EAST,UNITED ARAB EMIRATES,GLASGOW,DUBAI,40362,40362,0,29798,29798,0,35.45204376,August,2013
11/10/2013 11:57,201308,UNITED STATES OF AMERICA,USA,GLASGOW,NEW YORK (NEWARK),9733,9733,0,9295,9120,175,4.712210866,August,2013
11/10/2013 11:57,201308,UNITED STATES OF AMERICA,USA,GLASGOW,ORLANDO,4961,4961,0,4662,4662,0,6.413556414,August,2013
11/10/2013 11:57,201308,UNITED STATES OF AMERICA,USA,GLASGOW,PHILADELPHIA INTERNATIONAL,9756,9756,0,9024,9024,0,8.111702128,August,2013
11/10/2013 11:57,201308,UNITED STATES OF AMERICA,USA,GLASGOW,SANFORD,3545,945,2600,3986,0,3986,-11.06372303,August,2013
13/11/2013 12:56,201309,WESTERN EUROPE-EU,AUSTRIA,GLASGOW,SALZBURG,527,0,527,767,0,767,-31.29074316,September,2013
13/11/2013 12:56,201309,WESTERN EUROPE-EU,BELGIUM,GLASGOW,ANTWERP,99,0,99,0,0,0,0,September,2013
13/11/2013 12:56,201309,WESTERN EUROPE-EU,BELGIUM,GLASGOW,BRUSSELS,1343,0,1343,288,0,288,366.3194444,September,2013
13/11/2013 12:56,201309,EASTERN EUROPE-EU,BULGARIA,GLASGOW,BURGAS,5309,0,5309,5346,0,5346,-0.692106248,September,2013
13/11/2013 12:56,201309,CANADA,CANADA,GLASGOW,CALGARY,0,0,0,682,682,0,0,September,2013
13/11/2013 12:56,201309,CANADA,CANADA,GLASGOW,TORONTO,9648,9648,0,12128,12128,0,-20.44854881,September,2013
13/11/2013 12:56,201309,CANADA,CANADA,GLASGOW,VANCOUVER,2696,2696,0,2753,2753,0,-2.07046858,September,2013
13/11/2013 12:56,201309,ATLANTIC OCEAN ISLANDS,CAPE VERDE ISLANDS,GLASGOW,BOA VISTA (RABIL),0,0,0,2279,2279,0,0,September,2013
13/11/2013 12:56,201309,WESTERN EUROPE-EU,CROATIA,GLASGOW,DUBROVNIK,157,0,157,159,0,159,-1.257861635,September,2013
13/11/2013 12:56,201309,WESTERN EUROPE-EU,CROATIA,GLASGOW,PULA,741,741,0,0,0,0,0,September,2013
13/11/2013 12:56,201309,WESTERN EUROPE-EU,CROATIA,GLASGOW,ZAGREB,0,0,0,69,0,69,0,September,2013
13/11/2013 12:56,201309,WESTERN EUROPE-EU,CYPRUS,GLASGOW,LARNACA,6333,0,6333,8294,0,8294,-23.64359778,September,2013
13/11/2013 12:56,201309,WESTERN EUROPE-EU,CYPRUS,GLASGOW,PAPHOS,5970,3738,2232,9227,3974,5253,-35.29858025,September,2013
13/11/2013 12:56,201309,WESTERN EUROPE-EU,DENMARK,GLASGOW,COPENHAGEN,1641,1641,0,1820,1820,0,-9.835164835,September,2013
13/11/2013 12:56,201309,NORTH AFRICA,EGYPT,GLASGOW,SHARM EL SHEIKH (OPHIRA),5637,0,5637,6036,0,6036,-6.610337972,September,2013
13/11/2013 12:56,201309,WESTERN EUROPE-EU,FRANCE,GLASGOW,NICE,0,0,0,2175,2175,0,0,September,2013
13/11/2013 12:56,201309,WESTERN EUROPE-EU,FRANCE,GLASGOW,PARIS (CHARLES DE GAULLE),12264,12264,0,10757,10757,0,14.0094822,September,2013
13/11/2013 12:56,201309,WESTERN EUROPE-EU,GERMANY,GLASGOW,BERLIN (SCHONEFELD),6061,6061,0,7580,7580,0,-20.03957784,September,2013
13/11/2013 12:56,201309,WESTERN EUROPE-EU,GERMANY,GLASGOW,DUSSELDORF,3436,3436,0,0,0,0,0,September,2013
13/11/2013 12:56,201309,WESTERN EUROPE-EU,GREECE,GLASGOW,CORFU,3962,0,3962,5724,0,5724,-30.78266946,September,2013
13/11/2013 12:56,201309,WESTERN EUROPE-EU,GREECE,GLASGOW,HERAKLION,7994,2538,5456,7149,1421,5728,11.81983494,September,2013
13/11/2013 12:56,201309,WESTERN EUROPE-EU,GREECE,GLASGOW,KOS,1620,0,1620,1769,0,1769,-8.422837761,September,2013
13/11/2013 12:56,201309,WESTERN EUROPE-EU,GREECE,GLASGOW,RHODES,4966,1208,3758,5370,1217,4153,-7.523277467,September,2013
13/11/2013 12:56,201309,WESTERN EUROPE-EU,GREECE,GLASGOW,ZAKINTHOS,4633,0,4633,6288,0,6288,-26.31997455,September,2013
13/11/2013 12:56,201309,WESTERN EUROPE-OTHER,ICELAND,GLASGOW,KEFLAVIK,4651,4651,0,4662,4662,0,-0.235950236,September,2013
13/11/2013 12:56,201309,WESTERN EUROPE-EU,IRISH REPUBLIC,GLASGOW,CORK,1995,1995,0,1972,1972,0,1.1663286,September,2013
13/11/2013 12:56,201309,WESTERN EUROPE-EU,IRISH REPUBLIC,GLASGOW,DONEGAL,712,712,0,786,786,0,-9.41475827,September,2013
13/11/2013 12:56,201309,WESTERN EUROPE-EU,IRISH REPUBLIC,GLASGOW,DUBLIN,12748,12561,187,12243,12243,0,4.124806012,September,2013
13/11/2013 12:56,201309,WESTERN EUROPE-EU,IRISH REPUBLIC,GLASGOW,SHANNON,988,988,0,0,0,0,0,September,2013
13/11/2013 12:56,201309,WESTERN EUROPE-EU,ITALY,GLASGOW,BERGAMO,357,0,357,0,0,0,0,September,2013
13/11/2013 12:56,201309,WESTERN EUROPE-EU,ITALY,GLASGOW,MILAN (MALPENSA),275,0,275,0,0,0,0,September,2013
13/11/2013 12:56,201309,WESTERN EUROPE-EU,ITALY,GLASGOW,NAPLES,1470,0,1470,1787,0,1787,-17.73922776,September,2013
13/11/2013 12:56,201309,WESTERN EUROPE-EU,ITALY,GLASGOW,ROME (FIUMICINO),3572,3572,0,4545,4545,0,-21.40814081,September,2013
13/11/2013 12:56,201309,WESTERN EUROPE-EU,ITALY,GLASGOW,VENICE,573,0,573,1659,0,1659,-65.46112116,September,2013
13/11/2013 12:56,201309,WESTERN EUROPE-EU,ITALY,GLASGOW,VERONA VILLAFRANCA,2547,0,2547,2994,0,2994,-14.92985972,September,2013
13/11/2013 12:56,201309,WESTERN EUROPE-OTHER,MACEDONIA,GLASGOW,SKOPJE,203,0,203,66,0,66,207.5757576,September,2013
13/11/2013 12:56,201309,WESTERN EUROPE-EU,MALTA,GLASGOW,MALTA,1205,0,1205,1817,0,1817,-33.68189323,September,2013
13/11/2013 12:56,201309,CENTRAL AMERICA,MEXICO,GLASGOW,CANCUN,5159,0,5159,4320,0,4320,19.4212963,September,2013
13/11/2013 12:56,201309,WESTERN EUROPE-EU,NETHERLANDS,GLASGOW,AMSTERDAM,36802,36802,0,32685,32685,0,12.59599205,September,2013
13/11/2013 12:56,201309,WESTERN EUROPE-EU,NETHERLANDS,GLASGOW,MAASTRICHT,100,0,100,0,0,0,0,September,2013
13/11/2013 12:56,201309,WESTERN EUROPE-OTHER,NORWAY,GLASGOW,STAVANGER,0,0,0,214,214,0,0,September,2013
13/11/2013 12:56,201309,EASTERN EUROPE-EU,POLAND,GLASGOW,GDANSK,2802,2802,0,0,0,0,0,September,2013
13/11/2013 12:56,201309,EASTERN EUROPE-EU,POLAND,GLASGOW,KRAKOW,0,0,0,417,0,417,0,September,2013
13/11/2013 12:56,201309,EASTERN EUROPE-EU,POLAND,GLASGOW,WARSAW,2587,2587,0,0,0,0,0,September,2013
13/11/2013 12:56,201309,WESTERN EUROPE-EU,PORTUGAL(EXCLUDING MADEIRA),GLASGOW,FARO,11763,9243,2520,13888,9712,4176,-15.30097926,September,2013
13/11/2013 12:56,201309,WESTERN EUROPE-EU,PORTUGAL(EXCLUDING MADEIRA),GLASGOW,LISBON,0,0,0,305,0,305,0,September,2013
13/11/2013 12:56,201309,WESTERN EUROPE-EU,PORTUGAL(MADEIRA),GLASGOW,FUNCHAL,2219,0,2219,1825,0,1825,21.5890411,September,2013
13/11/2013 12:56,201309,WESTERN EUROPE-OTHER,REPUBLIC OF SERBIA,GLASGOW,BELGRADE,0,0,0,210,0,210,0,September,2013
13/11/2013 12:56,201309,EASTERN EUROPE -OTHER,RUSSIA,GLASGOW,MOSCOW (SHEREMETYEVO),0,0,0,57,0,57,0,September,2013
13/11/2013 12:56,201309,WESTERN EUROPE-EU,SPAIN,GLASGOW,ALICANTE,24484,17765,6719,22770,15737,7033,7.527448397,September,2013
13/11/2013 12:56,201309,WESTERN EUROPE-EU,SPAIN,GLASGOW,BARCELONA,5384,4282,1102,5833,4875,958,-7.697582719,September,2013
13/11/2013 12:56,201309,WESTERN EUROPE-EU,SPAIN,GLASGOW,IBIZA,13219,4505,8714,12395,2552,9843,6.647841872,September,2013
13/11/2013 12:56,201309,WESTERN EUROPE-EU,SPAIN,GLASGOW,MAHON,4940,734,4206,6003,0,6003,-17.70781276,September,2013
13/11/2013 12:56,201309,WESTERN EUROPE-EU,SPAIN,GLASGOW,MALAGA,18096,15535,2561,19215,15406,3809,-5.823575332,September,2013
13/11/2013 12:56,201309,WESTERN EUROPE-EU,SPAIN,GLASGOW,MURCIA SAN JAVIER,2610,2610,0,0,0,0,0,September,2013
13/11/2013 12:56,201309,WESTERN EUROPE-EU,SPAIN,GLASGOW,PALMA DE MALLORCA,38739,16112,22627,32218,13272,18946,20.24023838,September,2013
13/11/2013 12:56,201309,WESTERN EUROPE-EU,SPAIN,GLASGOW,REUS,3741,0,3741,4872,0,4872,-23.21428571,September,2013
13/11/2013 12:56,201309,WESTERN EUROPE-EU,SPAIN(CANARY ISLANDS),GLASGOW,ARRECIFE,9606,3625,5981,9728,1792,7936,-1.254111842,September,2013
13/11/2013 12:56,201309,WESTERN EUROPE-EU,SPAIN(CANARY ISLANDS),GLASGOW,FUERTEVENTURA,2421,0,2421,2338,0,2338,3.550042772,September,2013
13/11/2013 12:56,201309,WESTERN EUROPE-EU,SPAIN(CANARY ISLANDS),GLASGOW,LAS PALMAS,5726,1654,4072,3728,0,3728,53.5944206,September,2013
13/11/2013 12:56,201309,WESTERN EUROPE-EU,SPAIN(CANARY ISLANDS),GLASGOW,TENERIFE (SURREINA SOFIA),17944,7545,10399,19056,6018,13038,-5.83543241,September,2013
13/11/2013 12:56,201309,NORTH AFRICA,TUNISIA,GLASGOW,ENFIDHA - HAMMAMET INTL,6390,0,6390,4166,0,4166,53.38454153,September,2013
13/11/2013 12:56,201309,WESTERN EUROPE-OTHER,TURKEY,GLASGOW,ANTALYA,7569,0,7569,10052,0,10052,-24.70155193,September,2013
13/11/2013 12:56,201309,WESTERN EUROPE-OTHER,TURKEY,GLASGOW,BODRUM (MILAS),6810,2759,4051,6398,0,6398,6.439512348,September,2013
13/11/2013 12:56,201309,WESTERN EUROPE-OTHER,TURKEY,GLASGOW,DALAMAN,20565,6545,14020,21091,4728,16363,-2.493954767,September,2013
13/11/2013 12:56,201309,MIDDLE EAST,UNITED ARAB EMIRATES,GLASGOW,DUBAI,35620,35620,0,29115,29115,0,22.34243517,September,2013
13/11/2013 12:56,201309,UNITED STATES OF AMERICA,USA,GLASGOW,NEW YORK (NEWARK),9515,9515,0,8339,8339,0,14.10241036,September,2013
13/11/2013 12:56,201309,UNITED STATES OF AMERICA,USA,GLASGOW,ORLANDO,5593,5593,0,5707,5707,0,-1.997546872,September,2013
13/11/2013 12:56,201309,UNITED STATES OF AMERICA,USA,GLASGOW,PHILADELPHIA INTERNATIONAL,8764,8764,0,8261,8261,0,6.088851229,September,2013
13/11/2013 12:56,201309,UNITED STATES OF AMERICA,USA,GLASGOW,SANFORD,8240,5369,2871,7846,0,7846,5.021667092,September,2013
12/12/2013 12:08,201310,WESTERN EUROPE-EU,BELGIUM,GLASGOW,BRUSSELS,0,0,0,94,0,94,0,October,2013
12/12/2013 12:08,201310,WESTERN EUROPE-EU,BELGIUM,GLASGOW,LIEGE,60,0,60,0,0,0,0,October,2013
12/12/2013 12:08,201310,EASTERN EUROPE-EU,BULGARIA,GLASGOW,BURGAS,493,0,493,243,0,243,102.8806584,October,2013
12/12/2013 12:08,201310,CANADA,CANADA,GLASGOW,TORONTO,4836,4836,0,6915,6915,0,-30.06507592,October,2013
12/12/2013 12:08,201310,CANADA,CANADA,GLASGOW,VANCOUVER,2394,2394,0,2698,2698,0,-11.26760563,October,2013
12/12/2013 12:08,201310,ATLANTIC OCEAN ISLANDS,CAPE VERDE ISLANDS,GLASGOW,BOA VISTA (RABIL),0,0,0,1758,1758,0,0,October,2013
12/12/2013 12:08,201310,WESTERN EUROPE-EU,CROATIA,GLASGOW,ZAGREB,472,0,472,0,0,0,0,October,2013
12/12/2013 12:08,201310,WESTERN EUROPE-EU,CYPRUS,GLASGOW,LARNACA,3988,0,3988,6499,0,6499,-38.63671334,October,2013
12/12/2013 12:08,201310,WESTERN EUROPE-EU,CYPRUS,GLASGOW,PAPHOS,5746,3341,2405,8956,3216,5740,-35.8418937,October,2013
12/12/2013 12:08,201310,WESTERN EUROPE-EU,DENMARK,GLASGOW,COPENHAGEN,1582,1582,0,1434,1434,0,10.32078103,October,2013
12/12/2013 12:08,201310,NORTH AFRICA,EGYPT,GLASGOW,SHARM EL SHEIKH (OPHIRA),5176,0,5176,5910,0,5910,-12.41962775,October,2013
12/12/2013 12:08,201310,WESTERN EUROPE-EU,FRANCE,GLASGOW,PARIS (CHARLES DE GAULLE),12454,12454,0,11080,11020,60,12.40072202,October,2013
12/12/2013 12:08,201310,WESTERN EUROPE-EU,FRANCE,GLASGOW,TOULON / HYERES,77,0,77,0,0,0,0,October,2013
12/12/2013 12:08,201310,WESTERN EUROPE-EU,GERMANY,GLASGOW,BERLIN (SCHONEFELD),5981,5981,0,7472,7472,0,-19.95449679,October,2013
12/12/2013 12:08,201310,WESTERN EUROPE-EU,GERMANY,GLASGOW,DUSSELDORF,3069,3069,0,0,0,0,0,October,2013
12/12/2013 12:08,201310,WESTERN EUROPE-EU,GERMANY,GLASGOW,LEIPZIG,30,0,30,0,0,0,0,October,2013
12/12/2013 12:08,201310,WESTERN EUROPE-EU,GREECE,GLASGOW,CORFU,1696,0,1696,4338,0,4338,-60.90364223,October,2013
12/12/2013 12:08,201310,WESTERN EUROPE-EU,GREECE,GLASGOW,HERAKLION,5307,1577,3730,5399,1262,4137,-1.704019263,October,2013
12/12/2013 12:08,201310,WESTERN EUROPE-EU,GREECE,GLASGOW,KOS,235,0,235,631,0,631,-62.75752773,October,2013
12/12/2013 12:08,201310,WESTERN EUROPE-EU,GREECE,GLASGOW,RHODES,2550,0,2550,2639,0,2639,-3.372489579,October,2013
12/12/2013 12:08,201310,WESTERN EUROPE-EU,GREECE,GLASGOW,ZAKINTHOS,3656,0,3656,3180,0,3180,14.96855346,October,2013
12/12/2013 12:08,201310,WESTERN EUROPE-OTHER,ICELAND,GLASGOW,KEFLAVIK,5008,5008,0,3597,3597,0,39.22713372,October,2013
12/12/2013 12:08,201310,WESTERN EUROPE-EU,IRISH REPUBLIC,GLASGOW,CORK,2143,2106,37,2015,2015,0,6.35235732,October,2013
12/12/2013 12:08,201310,WESTERN EUROPE-EU,IRISH REPUBLIC,GLASGOW,DONEGAL,657,657,0,688,688,0,-4.505813953,October,2013
12/12/2013 12:08,201310,WESTERN EUROPE-EU,IRISH REPUBLIC,GLASGOW,DUBLIN,12521,12521,0,12657,12657,0,-1.074504227,October,2013
12/12/2013 12:08,201310,WESTERN EUROPE-EU,IRISH REPUBLIC,GLASGOW,SHANNON,749,749,0,0,0,0,0,October,2013
12/12/2013 12:08,201310,WESTERN EUROPE-EU,ITALY,GLASGOW,NAPLES,1254,0,1254,1568,0,1568,-20.0255102,October,2013
12/12/2013 12:08,201310,WESTERN EUROPE-EU,ITALY,GLASGOW,ROME (FIUMICINO),3229,3229,0,3798,3798,0,-14.98156925,October,2013
12/12/2013 12:08,201310,WESTERN EUROPE-EU,ITALY,GLASGOW,VENICE,484,0,484,330,0,330,46.66666667,October,2013
12/12/2013 12:08,201310,WESTERN EUROPE-EU,MALTA,GLASGOW,MALTA,1356,0,1356,2247,0,2247,-39.65287049,October,2013
12/12/2013 12:08,201310,CENTRAL AMERICA,MEXICO,GLASGOW,CANCUN,4256,0,4256,4410,0,4410,-3.492063492,October,2013
12/12/2013 12:08,201310,WESTERN EUROPE-EU,NETHERLANDS,GLASGOW,AMSTERDAM,34768,33801,967,33361,33361,0,4.217499475,October,2013
12/12/2013 12:08,201310,WESTERN EUROPE-OTHER,NORWAY,GLASGOW,STAVANGER,0,0,0,267,267,0,0,October,2013
12/12/2013 12:08,201310,EASTERN EUROPE-EU,POLAND,GLASGOW,GDANSK,2414,2414,0,0,0,0,0,October,2013
12/12/2013 12:08,201310,EASTERN EUROPE-EU,POLAND,GLASGOW,KRAKOW,428,0,428,0,0,0,0,October,2013
12/12/2013 12:08,201310,EASTERN EUROPE-EU,POLAND,GLASGOW,RZESZOW,69,0,69,0,0,0,0,October,2013
12/12/2013 12:08,201310,EASTERN EUROPE-EU,POLAND,GLASGOW,WARSAW (CHOPIN),2275,2275,0,0,0,0,0,October,2013
12/12/2013 12:08,201310,WESTERN EUROPE-EU,PORTUGAL(EXCLUDING MADEIRA),GLASGOW,FARO,11137,8517,2620,11821,7853,3968,-5.786312495,October,2013
12/12/2013 12:08,201310,WESTERN EUROPE-EU,PORTUGAL(MADEIRA),GLASGOW,FUNCHAL,1647,0,1647,2262,0,2262,-27.18832891,October,2013
12/12/2013 12:08,201310,EASTERN EUROPE -OTHER,RUSSIA,GLASGOW,MOSCOW (SHEREMETYEVO),0,0,0,57,0,57,0,October,2013
12/12/2013 12:08,201310,WESTERN EUROPE-EU,SPAIN,GLASGOW,ALICANTE,23918,15516,8402,23025,15111,7914,3.878393051,October,2013
12/12/2013 12:08,201310,WESTERN EUROPE-EU,SPAIN,GLASGOW,BARCELONA,4252,3596,656,6256,4328,1928,-32.03324808,October,2013
12/12/2013 12:08,201310,WESTERN EUROPE-EU,SPAIN,GLASGOW,IBIZA,7585,2024,5561,5245,0,5245,44.61391802,October,2013
12/12/2013 12:08,201310,WESTERN EUROPE-EU,SPAIN,GLASGOW,MAHON,2647,0,2647,3192,0,3192,-17.07393484,October,2013
12/12/2013 12:08,201310,WESTERN EUROPE-EU,SPAIN,GLASGOW,MALAGA,15720,13717,2003,15801,13026,2775,-0.512625783,October,2013
12/12/2013 12:08,201310,WESTERN EUROPE-EU,SPAIN,GLASGOW,MURCIA SAN JAVIER,1731,1731,0,0,0,0,0,October,2013
12/12/2013 12:08,201310,WESTERN EUROPE-EU,SPAIN,GLASGOW,PALMA DE MALLORCA,23898,9957,13941,21847,8128,13719,9.388016661,October,2013
12/12/2013 12:08,201310,WESTERN EUROPE-EU,SPAIN,GLASGOW,REUS,2295,0,2295,3197,0,3197,-28.21395058,October,2013
12/12/2013 12:08,201310,WESTERN EUROPE-EU,SPAIN(CANARY ISLANDS),GLASGOW,ARRECIFE,14172,3701,10471,15005,2885,12120,-5.551482839,October,2013
12/12/2013 12:08,201310,WESTERN EUROPE-EU,SPAIN(CANARY ISLANDS),GLASGOW,FUERTEVENTURA,6368,0,6368,4050,0,4050,57.2345679,October,2013
12/12/2013 12:08,201310,WESTERN EUROPE-EU,SPAIN(CANARY ISLANDS),GLASGOW,LAS PALMAS,6215,1489,4726,5698,0,5698,9.073359073,October,2013
12/12/2013 12:08,201310,WESTERN EUROPE-EU,SPAIN(CANARY ISLANDS),GLASGOW,TENERIFE (SURREINA SOFIA),25420,7696,17724,28634,5624,23010,-11.22441852,October,2013
12/12/2013 12:08,201310,WESTERN EUROPE-OTHER,SWITZERLAND,GLASGOW,GENEVA,34,0,34,0,0,0,0,October,2013
12/12/2013 12:08,201310,NORTH AFRICA,TUNISIA,GLASGOW,ENFIDHA - HAMMAMET INTL,6667,0,6667,5725,0,5725,16.45414847,October,2013
12/12/2013 12:08,201310,WESTERN EUROPE-OTHER,TURKEY,GLASGOW,ANTALYA,7945,0,7945,7735,0,7735,2.714932127,October,2013
12/12/2013 12:08,201310,WESTERN EUROPE-OTHER,TURKEY,GLASGOW,BODRUM (MILAS),4608,1241,3367,4289,0,4289,7.437631149,October,2013
12/12/2013 12:08,201310,WESTERN EUROPE-OTHER,TURKEY,GLASGOW,DALAMAN,19262,3971,15291,19189,2115,17074,0.380426286,October,2013
12/12/2013 12:08,201310,MIDDLE EAST,UNITED ARAB EMIRATES,GLASGOW,DUBAI,39116,39116,0,29712,29712,0,31.65051158,October,2013
12/12/2013 12:08,201310,UNITED STATES OF AMERICA,USA,GLASGOW,LAS VEGAS,421,0,421,309,0,309,36.24595469,October,2013
12/12/2013 12:08,201310,UNITED STATES OF AMERICA,USA,GLASGOW,NEW YORK (NEWARK),8984,8984,0,7738,7738,0,16.10235203,October,2013
12/12/2013 12:08,201310,UNITED STATES OF AMERICA,USA,GLASGOW,ORLANDO,4830,4830,0,4204,4204,0,14.8905804,October,2013
12/12/2013 12:08,201310,UNITED STATES OF AMERICA,USA,GLASGOW,PHILADELPHIA INTERNATIONAL,4677,4677,0,5376,5376,0,-13.00223214,October,2013
12/12/2013 12:08,201310,UNITED STATES OF AMERICA,USA,GLASGOW,SANFORD,5535,3843,1692,6332,0,6332,-12.58686039,October,2013
20/01/2014 14:40,201311,WESTERN EUROPE-EU,AUSTRIA,GLASGOW,VIENNA,46,0,46,0,0,0,0,November,2013
20/01/2014 14:40,201311,CARIBBEAN AREA,BARBADOS,GLASGOW,BRIDGETOWN,763,0,763,217,0,217,251.6129032,November,2013
20/01/2014 14:40,201311,CANADA,CANADA,GLASGOW,TORONTO,1736,1736,0,1850,1850,0,-6.162162162,November,2013
20/01/2014 14:40,201311,ATLANTIC OCEAN ISLANDS,CAPE VERDE ISLANDS,GLASGOW,BOA VISTA (RABIL),0,0,0,1712,1712,0,0,November,2013
20/01/2014 14:40,201311,WESTERN EUROPE-EU,CYPRUS,GLASGOW,LARNACA,151,0,151,0,0,0,0,November,2013
20/01/2014 14:40,201311,WESTERN EUROPE-EU,CYPRUS,GLASGOW,PAPHOS,1499,0,1499,2043,0,2043,-26.62750857,November,2013
20/01/2014 14:40,201311,WESTERN EUROPE-EU,DENMARK,GLASGOW,COPENHAGEN,713,713,0,863,863,0,-17.38122827,November,2013
20/01/2014 14:40,201311,WESTERN EUROPE-EU,DENMARK,GLASGOW,ROSKILDE,0,0,0,154,0,154,0,November,2013
20/01/2014 14:40,201311,NORTH AFRICA,EGYPT,GLASGOW,SHARM EL SHEIKH (OPHIRA),3012,0,3012,3923,0,3923,-23.22202396,November,2013
20/01/2014 14:40,201311,WESTERN EUROPE-EU,FRANCE,GLASGOW,MARSEILLE,172,0,172,0,0,0,0,November,2013
20/01/2014 14:40,201311,WESTERN EUROPE-EU,FRANCE,GLASGOW,PARIS (CHARLES DE GAULLE),9025,9025,0,8880,8880,0,1.632882883,November,2013
20/01/2014 14:40,201311,WESTERN EUROPE-EU,GERMANY,GLASGOW,BERLIN (SCHONEFELD),5747,5747,0,6349,6349,0,-9.481808159,November,2013
20/01/2014 14:40,201311,WESTERN EUROPE-EU,GERMANY,GLASGOW,DUSSELDORF,2715,2715,0,0,0,0,0,November,2013
20/01/2014 14:40,201311,WESTERN EUROPE-EU,GERMANY,GLASGOW,MUNICH,80,0,80,0,0,0,0,November,2013
20/01/2014 14:40,201311,WESTERN EUROPE-EU,GREECE,GLASGOW,CORFU,433,0,433,0,0,0,0,November,2013
20/01/2014 14:40,201311,WESTERN EUROPE-OTHER,ICELAND,GLASGOW,KEFLAVIK,4830,4637,193,3599,3599,0,34.20394554,November,2013
20/01/2014 14:40,201311,WESTERN EUROPE-EU,IRISH REPUBLIC,GLASGOW,CORK,1507,1507,0,1742,1742,0,-13.4902411,November,2013
20/01/2014 14:40,201311,WESTERN EUROPE-EU,IRISH REPUBLIC,GLASGOW,DONEGAL,686,686,0,620,620,0,10.64516129,November,2013
20/01/2014 14:40,201311,WESTERN EUROPE-EU,IRISH REPUBLIC,GLASGOW,DUBLIN,10515,10500,15,11666,11546,120,-9.866278073,November,2013
20/01/2014 14:40,201311,WESTERN EUROPE-EU,IRISH REPUBLIC,GLASGOW,SHANNON,743,743,0,0,0,0,0,November,2013
20/01/2014 14:40,201311,WESTERN EUROPE-EU,ITALY,GLASGOW,MILAN (MALPENSA),240,0,240,0,0,0,0,November,2013
20/01/2014 14:40,201311,WESTERN EUROPE-EU,ITALY,GLASGOW,ROME (FIUMICINO),179,179,0,0,0,0,0,November,2013
20/01/2014 14:40,201311,WESTERN EUROPE-EU,LUXEMBOURG,GLASGOW,LUXEMBOURG,0,0,0,186,0,186,0,November,2013
20/01/2014 14:40,201311,WESTERN EUROPE-EU,MALTA,GLASGOW,MALTA,0,0,0,667,0,667,0,November,2013
20/01/2014 14:40,201311,CENTRAL AMERICA,MEXICO,GLASGOW,CANCUN,0,0,0,554,0,554,0,November,2013
20/01/2014 14:40,201311,WESTERN EUROPE-EU,NETHERLANDS,GLASGOW,AMSTERDAM,29711,27468,2243,28990,28990,0,2.487064505,November,2013
20/01/2014 14:40,201311,WESTERN EUROPE-OTHER,NORWAY,GLASGOW,KRISTIANSUND (KUERNBERGET),182,0,182,0,0,0,0,November,2013
20/01/2014 14:40,201311,WESTERN EUROPE-OTHER,NORWAY,GLASGOW,STAVANGER,0,0,0,238,238,0,0,November,2013
20/01/2014 14:40,201311,EASTERN EUROPE-EU,POLAND,GLASGOW,GDANSK,2484,2484,0,0,0,0,0,November,2013
20/01/2014 14:40,201311,EASTERN EUROPE-EU,POLAND,GLASGOW,WARSAW (CHOPIN),2517,2517,0,0,0,0,0,November,2013
20/01/2014 14:40,201311,WESTERN EUROPE-EU,PORTUGAL(EXCLUDING MADEIRA),GLASGOW,FARO,3263,3263,0,2804,2804,0,16.36947218,November,2013
20/01/2014 14:40,201311,WESTERN EUROPE-EU,PORTUGAL(EXCLUDING MADEIRA),GLASGOW,LISBON,415,0,415,2429,0,2429,-82.91477974,November,2013
20/01/2014 14:40,201311,WESTERN EUROPE-EU,PORTUGAL(MADEIRA),GLASGOW,FUNCHAL,1589,0,1589,1782,0,1782,-10.8305275,November,2013
20/01/2014 14:40,201311,WESTERN EUROPE-EU,SPAIN,GLASGOW,ALICANTE,13465,9265,4200,12509,7649,4860,7.642497402,November,2013
20/01/2014 14:40,201311,WESTERN EUROPE-EU,SPAIN,GLASGOW,BARCELONA,2867,2867,0,281,0,281,920.2846975,November,2013
20/01/2014 14:40,201311,WESTERN EUROPE-EU,SPAIN,GLASGOW,MALAGA,6729,6729,0,6790,6790,0,-0.898379971,November,2013
20/01/2014 14:40,201311,WESTERN EUROPE-EU,SPAIN,GLASGOW,PALMA DE MALLORCA,3211,2777,434,2326,2326,0,38.04815133,November,2013
20/01/2014 14:40,201311,WESTERN EUROPE-EU,SPAIN,GLASGOW,ZARAGOZA,0,0,0,318,0,318,0,November,2013
20/01/2014 14:40,201311,WESTERN EUROPE-EU,SPAIN(CANARY ISLANDS),GLASGOW,ARRECIFE,9373,3957,5416,10489,3935,6554,-10.6397178,November,2013
20/01/2014 14:40,201311,WESTERN EUROPE-EU,SPAIN(CANARY ISLANDS),GLASGOW,FUERTEVENTURA,4883,0,4883,4339,0,4339,12.53745103,November,2013
20/01/2014 14:40,201311,WESTERN EUROPE-EU,SPAIN(CANARY ISLANDS),GLASGOW,LAS PALMAS,5300,1421,3879,4058,0,4058,30.60620996,November,2013
20/01/2014 14:40,201311,WESTERN EUROPE-EU,SPAIN(CANARY ISLANDS),GLASGOW,TENERIFE (SURREINA SOFIA),22046,6494,15552,18346,4670,13676,20.16788401,November,2013
20/01/2014 14:40,201311,NORTH AFRICA,TUNISIA,GLASGOW,ENFIDHA - HAMMAMET INTL,3615,0,3615,2048,0,2048,76.51367188,November,2013
20/01/2014 14:40,201311,WESTERN EUROPE-OTHER,TURKEY,GLASGOW,ANTALYA,2424,0,2424,2331,0,2331,3.98970399,November,2013
20/01/2014 14:40,201311,WESTERN EUROPE-OTHER,TURKEY,GLASGOW,DALAMAN,209,0,209,0,0,0,0,November,2013
20/01/2014 14:40,201311,MIDDLE EAST,UNITED ARAB EMIRATES,GLASGOW,DUBAI,34578,34578,0,28041,28041,0,23.31229271,November,2013
20/01/2014 14:40,201311,UNITED STATES OF AMERICA,USA,GLASGOW,LAS VEGAS,0,0,0,309,0,309,0,November,2013
20/01/2014 14:40,201311,UNITED STATES OF AMERICA,USA,GLASGOW,NEW YORK (NEWARK),8271,7823,448,8118,7683,435,1.884700665,November,2013
20/01/2014 14:40,201311,UNITED STATES OF AMERICA,USA,GLASGOW,SANFORD,0,0,0,509,0,509,0,November,2013
18/02/2014 08:05,201312,WESTERN EUROPE-EU,AUSTRIA,GLASGOW,SALZBURG,220,0,220,206,0,206,6.796116505,December,2013
18/02/2014 08:05,201312,CARIBBEAN AREA,BARBADOS,GLASGOW,BRIDGETOWN,980,0,980,453,0,453,116.3355408,December,2013
18/02/2014 08:05,201312,CANADA,CANADA,GLASGOW,TORONTO,1505,1505,0,2216,2216,0,-32.08483755,December,2013
18/02/2014 08:05,201312,ATLANTIC OCEAN ISLANDS,CAPE VERDE ISLANDS,GLASGOW,BOA VISTA (RABIL),0,0,0,1846,1846,0,0,December,2013
18/02/2014 08:05,201312,WESTERN EUROPE-EU,CYPRUS,GLASGOW,PAPHOS,0,0,0,1459,0,1459,0,December,2013
18/02/2014 08:05,201312,WESTERN EUROPE-EU,DENMARK,GLASGOW,COPENHAGEN,762,692,70,389,389,0,95.88688946,December,2013
18/02/2014 08:05,201312,NORTH AFRICA,EGYPT,GLASGOW,SHARM EL SHEIKH (OPHIRA),2957,0,2957,3812,0,3812,-22.42917104,December,2013
18/02/2014 08:05,201312,WESTERN EUROPE-EU,FINLAND,GLASGOW,ENONTEKIO,1217,0,1217,1016,0,1016,19.78346457,December,2013
18/02/2014 08:05,201312,WESTERN EUROPE-EU,FINLAND,GLASGOW,KITTILA,442,0,442,778,0,778,-43.18766067,December,2013
18/02/2014 08:05,201312,WESTERN EUROPE-EU,FINLAND,GLASGOW,ROVANIEMI,460,0,460,922,0,922,-50.10845987,December,2013
18/02/2014 08:05,201312,WESTERN EUROPE-EU,FRANCE,GLASGOW,CASTRES,0,0,0,107,0,107,0,December,2013
18/02/2014 08:05,201312,WESTERN EUROPE-EU,FRANCE,GLASGOW,CHAMBERY,219,0,219,234,0,234,-6.41025641,December,2013
18/02/2014 08:05,201312,WESTERN EUROPE-EU,FRANCE,GLASGOW,PARIS (CHARLES DE GAULLE),10907,10907,0,10633,10633,0,2.576883288,December,2013
18/02/2014 08:05,201312,WESTERN EUROPE-EU,GERMANY,GLASGOW,BERLIN (SCHONEFELD),5798,5798,0,6602,6602,0,-12.17812784,December,2013
18/02/2014 08:05,201312,WESTERN EUROPE-EU,GERMANY,GLASGOW,DUSSELDORF,2514,2514,0,0,0,0,0,December,2013
18/02/2014 08:05,201312,WESTERN EUROPE-OTHER,ICELAND,GLASGOW,KEFLAVIK,4098,4098,0,2948,2948,0,39.00949796,December,2013
18/02/2014 08:05,201312,WESTERN EUROPE-EU,IRISH REPUBLIC,GLASGOW,CORK,1457,1457,0,1742,1742,0,-16.36050517,December,2013
18/02/2014 08:05,201312,WESTERN EUROPE-EU,IRISH REPUBLIC,GLASGOW,DONEGAL,666,666,0,626,626,0,6.389776358,December,2013
18/02/2014 08:05,201312,WESTERN EUROPE-EU,IRISH REPUBLIC,GLASGOW,DUBLIN,10799,10799,0,10356,10248,108,4.277713403,December,2013
18/02/2014 08:05,201312,WESTERN EUROPE-EU,IRISH REPUBLIC,GLASGOW,SHANNON,534,534,0,0,0,0,0,December,2013
18/02/2014 08:05,201312,WESTERN EUROPE-EU,ITALY,GLASGOW,TURIN,209,0,209,232,0,232,-9.913793103,December,2013
18/02/2014 08:05,201312,WESTERN EUROPE-EU,NETHERLANDS,GLASGOW,AMSTERDAM,27861,27861,0,30245,30245,0,-7.882294594,December,2013
18/02/2014 08:05,201312,WESTERN EUROPE-EU,NETHERLANDS,GLASGOW,MAASTRICHT,0,0,0,73,0,73,0,December,2013
18/02/2014 08:05,201312,WESTERN EUROPE-OTHER,NORWAY,GLASGOW,STAVANGER,0,0,0,159,159,0,0,December,2013
18/02/2014 08:05,201312,EASTERN EUROPE-EU,POLAND,GLASGOW,GDANSK,2639,2639,0,0,0,0,0,December,2013
18/02/2014 08:05,201312,EASTERN EUROPE-EU,POLAND,GLASGOW,WARSAW (CHOPIN),2645,2645,0,0,0,0,0,December,2013
18/02/2014 08:05,201312,WESTERN EUROPE-EU,PORTUGAL(EXCLUDING MADEIRA),GLASGOW,FARO,3047,3047,0,2701,2701,0,12.81007034,December,2013
18/02/2014 08:05,201312,WESTERN EUROPE-EU,PORTUGAL(EXCLUDING MADEIRA),GLASGOW,LISBON,0,0,0,230,0,230,0,December,2013
18/02/2014 08:05,201312,WESTERN EUROPE-EU,PORTUGAL(MADEIRA),GLASGOW,FUNCHAL,1801,0,1801,1864,0,1864,-3.379828326,December,2013
18/02/2014 08:05,201312,EASTERN EUROPE -OTHER,RUSSIA,GLASGOW,MOSCOW (SHEREMETYEVO),0,0,0,79,0,79,0,December,2013
18/02/2014 08:05,201312,WESTERN EUROPE-EU,SPAIN,GLASGOW,ALICANTE,9369,7507,1862,6451,4773,1678,45.23329716,December,2013
18/02/2014 08:05,201312,WESTERN EUROPE-EU,SPAIN,GLASGOW,BARCELONA,3853,3162,691,0,0,0,0,December,2013
18/02/2014 08:05,201312,WESTERN EUROPE-EU,SPAIN,GLASGOW,MALAGA,6020,6020,0,6865,6855,10,-12.30881282,December,2013
18/02/2014 08:05,201312,WESTERN EUROPE-EU,SPAIN,GLASGOW,PALMA DE MALLORCA,1775,1775,0,1724,1724,0,2.958236659,December,2013
18/02/2014 08:05,201312,WESTERN EUROPE-EU,SPAIN(CANARY ISLANDS),GLASGOW,ARRECIFE,8975,3617,5358,9159,3319,5840,-2.008952942,December,2013
18/02/2014 08:05,201312,WESTERN EUROPE-EU,SPAIN(CANARY ISLANDS),GLASGOW,FUERTEVENTURA,2820,0,2820,4270,0,4270,-33.95784543,December,2013
18/02/2014 08:05,201312,WESTERN EUROPE-EU,SPAIN(CANARY ISLANDS),GLASGOW,LAS PALMAS,4595,1349,3246,3865,0,3865,18.88745149,December,2013
18/02/2014 08:05,201312,WESTERN EUROPE-EU,SPAIN(CANARY ISLANDS),GLASGOW,TENERIFE (SURREINA SOFIA),20719,6219,14500,16242,4332,11910,27.56433937,December,2013
18/02/2014 08:05,201312,WESTERN EUROPE-OTHER,SWITZERLAND,GLASGOW,GENEVA,1864,1864,0,2130,2130,0,-12.48826291,December,2013
18/02/2014 08:05,201312,NORTH AFRICA,TUNISIA,GLASGOW,ENFIDHA - HAMMAMET INTL,1905,0,1905,182,0,182,946.7032967,December,2013
18/02/2014 08:05,201312,WESTERN EUROPE-OTHER,TURKEY,GLASGOW,ANTALYA,835,0,835,474,0,474,76.16033755,December,2013
18/02/2014 08:05,201312,MIDDLE EAST,UNITED ARAB EMIRATES,GLASGOW,DUBAI,35685,35685,0,29438,29438,0,21.22087098,December,2013
18/02/2014 08:05,201312,UNITED STATES OF AMERICA,USA,GLASGOW,NEW YORK (NEWARK),8202,8202,0,7517,7517,0,9.11267793,December,2013
